Zona;Sede;Año;Mes;Ingresos;Costos;Ut_Bruta;Gastos;Ut_Operativa;Empl_Admon;Empl_Operativo;Ordenes;Hrs_Reales;Hrs_Posibles;Nivel_rentab
Zonas Secundarias;Medellin Alistamiento;2021;ene;130985262;75747717;55237545;22969352;32268193;0;11;297;725;1120;Media
Zonas Secundarias;Medellin Alistamiento;2021;feb;153990095;60845429;93144666;15689387;77455279;1;10;342;924;960;Alta
Zonas Secundarias;Medellin Alistamiento;2021;mar;202392276;82840534;119551742;17039667;102512075;1;10;592;1084;960;Alta
Zonas Secundarias;Medellin Alistamiento;2021;abr;143886122;72250513;71635609;9173052;62462557;1;10;426;752;960;Alta
Zonas Secundarias;Medellin Alistamiento;2021;may;110708724;63899043;46809681;14075570;32734111;1;10;297;544;960;Media
Zonas Secundarias;Medellin Alistamiento;2021;jun;171542134;90968813;80573321;18437959;62135362;1;12;496;860;960;Media
Zonas Secundarias;Medellin Alistamiento;2021;jul;196665613;95326747;101338866;19012117;82326749;1;12;453;958;960;Media
Zonas Secundarias;Medellin Alistamiento;2021;ago;194389471;92556687;101832784;15821869;86010915;1;13;458;1005;1120;Alta
Zonas Secundarias;Medellin Alistamiento;2021;sep;238091585;124583390;113508195;20173258;93334937;1;12;575;1123;1120;Media
Zonas Secundarias;Medellin Alistamiento;2021;oct;172459483;85545077;86914406;18066422;68847984;1;12;439;859;1120;Media
Zonas Secundarias;Medellin Alistamiento;2021;nov;178159892;85222053;92937839;13119276;79818563;0;11;427;854;960;Alta
Zonas Secundarias;Medellin Alistamiento;2021;dic;153266562;74906874;78359688;4471574;73888114;0;11;345;707;960;Alta
Zonas Secundarias;Medellin Alistamiento;2022;ene;68153785;62997120;5156665;8869714;-3713049;0;11;159;318;960;Perdida
Zonas Secundarias;Medellin Alistamiento;2022;feb;128016801;76165476;51851325;9815933;42035392;0;11;282;587;800;Media
Zonas Secundarias;Medellin Alistamiento;2022;mar;96480781;62076029;34404752;12884899;21519853;0;11;210;461;800;Media
Zonas Secundarias;Medellin Alistamiento;2022;abr;135706466;74041702;61664764;17082000;44582764;1;10;283;677;800;Media
Zonas Secundarias;Medellin Alistamiento;2022;may;138842141;71257631;67584510;16392228;51192282;1;10;267;672;800;Media
Zonas Secundarias;Medellin Alistamiento;2022;jun;137241577;78271289;58970288;16266080;42704208;1;10;250;566;800;Media
Zonas Secundarias;Medellin Alistamiento;2022;jul;124137159;77326230;46810929;16585174;30225755;1;10;247;542;800;Media
Zonas Secundarias;Medellin Alistamiento;2022;ago;110530573;62942683;47587890;16772796;30815094;1;10;230;527;800;Media
Zonas Secundarias;Medellin Alistamiento;2022;sep;85936908;68266777;17670131;17017684;652447;1;10;166;357;800;Perdida
Zonas Secundarias;Medellin Alistamiento;2022;oct;50392353;47080131;3312222;14026388;-10714166;1;10;106;223;800;Perdida
Zonas Secundarias;Medellin Alistamiento;2022;nov;72499625;57459455;15040170;15323651;-283481;1;10;128;289;1600;Perdida
Zonas Secundarias;Medellin Alistamiento;2022;dic;64244272;51866432;12377840;15913694;-3535854;1;10;125;253;800;Perdida
Zonas Secundarias;Medellin Alistamiento;2023;ene;48926451;52516670;-3590219;11952183;-15542402;1;10;89;176;800;Perdida
Zonas Secundarias;Medellin Alistamiento;2023;feb;78099848;63940135;14159713;18705128;-4545415;1;10;121;297;800;Perdida
Zonas Secundarias;Medellin Alistamiento;2023;mar;117394259;84062414;33331845;13881877;19449968;1;10;196;404;800;Baja
Zonas Secundarias;Medellin Alistamiento;2023;abr;136594723;85176649;51418074;26021740;25396334;1;9;230;496;800;Baja
Zonas Secundarias;Medellin Alistamiento;2023;may;133233185;77575724;55657461;13116194;42541267;1;9;237;505;800;Media
Zonas Secundarias;Medellin Alistamiento;2023;jun;102482970;65627802;36855168;22396727;14458441;1;9;176;392;800;Baja
Zonas Secundarias;Medellin Alistamiento;2023;jul;104751930;61849130;42902800;13429371;29473429;1;9;176;405;800;Media
Zonas Secundarias;Medellin Alistamiento;2023;ago;107044799;62735639;44309160;22481721;21827439;1;8;201;437;640;Baja
Zonas Secundarias;Medellin Alistamiento;2023;sep;167583260;54850487;112732773;14025088;98707685;1;7;282;628;480;Alta
Zonas Secundarias;Medellin Alistamiento;2023;oct;155996793;76456269;79540524;32422593;47117931;0;7;261;537;480;Media
Zonas Secundarias;Medellin Alistamiento;2023;nov;133450241;71720086;61730155;15942907;45787248;0;7;225;443;480;Media
Zonas Secundarias;Medellin Alistamiento;2023;dic;168656138;52310666;116345472;7550819;108794653;0;8;244;539;480;Alta
Zonas Secundarias;Medellin Alistamiento;2024;ene;90612364;61336886;29275478;11812655;17462823;0;8;149;323;480;Baja
Zonas Secundarias;Medellin Alistamiento;2024;feb;189281647;97648360;91633287;10978307;80654980;0;9;271;647;640;Media
Zonas Secundarias;Medellin Alistamiento;2024;mar;181859179;93475073;88384106;11402334;76981772;0;9;284;616;640;Media
Zonas Secundarias;Medellin Alistamiento;2024;abr;182753168;76325133;106428035;12375375;94052660;0;9;262;615;640;Alta
Zonas Secundarias;Medellin Alistamiento;2024;may;190434537;102311262;88123275;14176982;73946293;0;8;256;634;640;Media
Zonas Secundarias;Medellin Alistamiento;2024;jun;144062952;66040739;78022213;11159000;66863213;0;8;185;504;640;Alta
Zonas Secundarias;Medellin Alistamiento;2024;jul;147873954;82492396;65381558;12166633;53214925;0;8;226;484;640;Media
Zonas Secundarias;Medellin Alistamiento;2024;ago;183560157;88170878;95389279;13241651;82147628;0;7;281;584;640;Alta
Zonas Secundarias;Medellin Alistamiento;2024;sep;195645495;84426017;111219478;12406213;98813265;0;8;259;638;640;Alta
Zonas Secundarias;Medellin Alistamiento;2024;oct;249241865;95287238;153954627;15512736;138441891;0;8;316;764;640;Alta
Zonas Secundarias;Medellin Alistamiento;2024;nov;193227091;79718621;113508470;14545389;98963081;0;7;266;643;640;Alta
Zonas Secundarias;Medellin Alistamiento;2024;dic;311779966;100438943;211341023;29145388;182195635;0;7;392;1030;640;Alta
Zonas Secundarias;Medellin Colision;2021;ene;465737862;255291554;210446308;239366716;-28920408;16;36;226;5311;5800;Perdida
Zonas Secundarias;Medellin Colision;2021;feb;669124001;269912656;399211345;234980608;164230737;17;35;293;7602;5640;Media
Zonas Secundarias;Medellin Colision;2021;mar;629451377;350543019;278908358;240258740;38649618;15;32;266;7211;5120;Baja
Zonas Secundarias;Medellin Colision;2021;abr;364020170;265348256;98671914;207665325;-108993411;15;32;155;5542;5120;Perdida
Zonas Secundarias;Medellin Colision;2021;may;464654813;288301353;176353460;239613299;-63259839;16;32;238;5949;5120;Perdida
Zonas Secundarias;Medellin Colision;2021;jun;578128025;310535693;267592332;253102289;14490043;18;31;255;6530;5120;Baja
Zonas Secundarias;Medellin Colision;2021;jul;520844648;307020220;213824428;242350100;-28525672;18;35;261;6081;5760;Perdida
Zonas Secundarias;Medellin Colision;2021;ago;620180124;357144019;263036105;265066321;-2030216;18;36;257;7470;5920;Perdida
Zonas Secundarias;Medellin Colision;2021;sep;661528648;497581818;163946830;311963509;-148016679;19;36;296;7814;5920;Perdida
Zonas Secundarias;Medellin Colision;2021;oct;629094107;346300071;282794036;269275631;13518405;19;36;256;7387;5760;Baja
Zonas Secundarias;Medellin Colision;2021;nov;627530453;331745058;295785395;316878830;-21093435;21;36;281;7279;5800;Perdida
Zonas Secundarias;Medellin Colision;2021;dic;512858902;352601984;160256918;252023882;-91766964;21;36;265;5557;5800;Perdida
Zonas Secundarias;Medellin Colision;2022;ene;607647151;314936138;292711013;295672888;-2961875;20;38;280;7028;5960;Perdida
Zonas Secundarias;Medellin Colision;2022;feb;696818218;370431537;326386681;291785281;34601400;20;37;327;7914;6040;Baja
Zonas Secundarias;Medellin Colision;2022;mar;741310088;392689541;348620547;307347627;41272920;23;39;334;8619;6200;Baja
Zonas Secundarias;Medellin Colision;2022;abr;627767148;352912961;274854187;305679841;-30825654;22;39;291;7108;6160;Perdida
Zonas Secundarias;Medellin Colision;2022;may;777969672;385914481;392055191;307180398;84874793;22;39;312;8807;6160;Baja
Zonas Secundarias;Medellin Colision;2022;jun;657681627;413935260;243746367;315692889;-71946522;22;40;275;7393;6360;Perdida
Zonas Secundarias;Medellin Colision;2022;jul;516408298;391265467;125142831;312491488;-187348657;23;38;276;5809;5840;Perdida
Zonas Secundarias;Medellin Colision;2022;ago;794522823;360003995;434518828;306256004;128262824;24;40;301;8464;6160;Baja
Zonas Secundarias;Medellin Colision;2022;sep;874671097;412913817;461757280;351445086;110312194;21;44;324;8986;6400;Baja
Zonas Secundarias;Medellin Colision;2022;oct;599916207;407629177;192287030;265051799;-72764769;22;44;267;6254;6400;Perdida
Zonas Secundarias;Medellin Colision;2022;nov;692210358;361510284;330700074;300916343;29783731;28;38;281;7243;6720;Baja
Zonas Secundarias;Medellin Colision;2022;dic;605049830;435353413;169696417;265564758;-95868341;19;45;286;5664;6600;Perdida
Zonas Secundarias;Medellin Colision;2023;ene;766894024;375634640;391259384;288439686;102819698;20;48;300;8323;7080;Baja
Zonas Secundarias;Medellin Colision;2023;feb;882632050;419619073;463012977;278595072;184417905;19;48;315;9146;7080;Baja
Zonas Secundarias;Medellin Colision;2023;mar;970400003;490983073;479416930;350859958;128556972;22;48;352;9871;6960;Baja
Zonas Secundarias;Medellin Colision;2023;abr;642717235;480143230;162574005;295811812;-133237807;26;48;289;6363;7120;Perdida
Zonas Secundarias;Medellin Colision;2023;may;907800786;450886387;456914399;341303488;115610911;27;50;311;8588;7280;Baja
Zonas Secundarias;Medellin Colision;2023;jun;876512969;477455195;399057774;369542583;29515191;27;50;294;7861;7280;Baja
Zonas Secundarias;Medellin Colision;2023;jul;813722959;411370944;402352015;324643902;77708113;25;48;296;7453;6560;Baja
Zonas Secundarias;Medellin Colision;2023;ago;750173250;462465574;287707676;306061186;-18353510;26;46;263;6950;6360;Perdida
Zonas Secundarias;Medellin Colision;2023;sep;809494721;401290749;408203972;263797530;144406442;25;39;302;7424;5440;Baja
Zonas Secundarias;Medellin Colision;2023;oct;783176662;408938089;374238573;304893919;69344654;25;38;322;7235;5280;Baja
Zonas Secundarias;Medellin Colision;2023;nov;819556656;493684039;325872617;317538698;8333919;24;35;252;7736;5080;Baja
Zonas Secundarias;Medellin Colision;2023;dic;504982618;295982570;209000048;291416116;-82416068;25;33;225;4343;4920;Perdida
Zonas Secundarias;Medellin Colision;2024;ene;826655552;517454273;309201279;339603146;-30401867;25;34;249;7697;5120;Perdida
Zonas Secundarias;Medellin Colision;2024;feb;852623402;319700351;532923051;348441040;184482011;25;36;289;8145;5480;Baja
Zonas Secundarias;Medellin Colision;2024;mar;737551428;386017630;351533798;361684006;-10150208;22;33;249;6512;5080;Perdida
Zonas Secundarias;Medellin Colision;2024;abr;887827379;499783003;388044376;284258386;103785990;21;34;295;7845;5280;Baja
Zonas Secundarias;Medellin Colision;2024;may;921295942;445622416;475673526;359160838;116512688;24;39;300;7781;5840;Baja
Zonas Secundarias;Medellin Colision;2024;jun;689076488;363611997;325464491;307926919;17537572;27;39;263;5488;5840;Baja
Zonas Secundarias;Medellin Colision;2024;jul;1038888473;565333169;473555304;425534970;48020334;27;38;326;9032;5680;Baja
Zonas Secundarias;Medellin Colision;2024;ago;832405837;477073518;355332319;320973688;34358631;26;39;267;6777;5840;Baja
Zonas Secundarias;Medellin Colision;2024;sep;850705214;482020233;368684981;368526690;158291;24;41;265;7550;6480;Perdida
Zonas Secundarias;Medellin Colision;2024;oct;956390518;461984611;494405907;336455206;157950701;24;41;291;8229;6280;Baja
Zonas Secundarias;Medellin Colision;2024;nov;743169158;470573843;272595315;329271286;-56675971;23;41;248;6725;6280;Perdida
Zonas Secundarias;Medellin Colision;2024;dic;754237717;469789162;284448555;414863331;-130414776;23;40;248;6445;6080;Perdida
Zonas Secundarias;Medellin Nutibara;2021;ene;320040525;137433381;182607144;98568997;84038147;11;16;726;2097;2380;Media
Zonas Secundarias;Medellin Nutibara;2021;feb;367150739;166053906;201096833;124872602;76224231;12;18;853;2372;2700;Baja
Zonas Secundarias;Medellin Nutibara;2021;mar;394170709;164105570;230065139;132045144;98019995;12;18;883;2485;2700;Media
Zonas Secundarias;Medellin Nutibara;2021;abr;285676561;141978437;143698124;121472622;22225502;12;18;675;1834;2700;Baja
Zonas Secundarias;Medellin Nutibara;2021;may;333379584;165045894;168333690;120473079;47860611;12;17;692;2061;2540;Baja
Zonas Secundarias;Medellin Nutibara;2021;jun;304102573;141955010;162147563;137664231;24483332;13;16;681;1962;2540;Baja
Zonas Secundarias;Medellin Nutibara;2021;jul;428522663;191155570;237367093;130448767;106918326;13;16;900;2531;2540;Media
Zonas Secundarias;Medellin Nutibara;2021;ago;392685660;181087775;211597885;151458918;60138967;13;16;876;2470;2540;Baja
Zonas Secundarias;Medellin Nutibara;2021;sep;396179918;177968649;218211269;164314600;53896669;13;16;1007;2572;2540;Baja
Zonas Secundarias;Medellin Nutibara;2021;oct;420307884;191162335;229145549;141553844;87591705;13;16;992;2632;2540;Baja
Zonas Secundarias;Medellin Nutibara;2021;nov;447925091;202072279;245852812;155020164;90832648;14;18;990;2840;2860;Baja
Zonas Secundarias;Medellin Nutibara;2021;dic;465172998;226732961;238440037;177086767;61353270;14;18;1013;2803;2860;Baja
Zonas Secundarias;Medellin Nutibara;2022;ene;389650528;195491828;194158700;135856071;58302629;14;19;920;2352;3020;Baja
Zonas Secundarias;Medellin Nutibara;2022;feb;408038435;188110516;219927919;155741104;64186815;13;19;1047;2784;3020;Baja
Zonas Secundarias;Medellin Nutibara;2022;mar;486808342;228239294;258569048;132522179;126046869;13;18;1092;2966;2860;Media
Zonas Secundarias;Medellin Nutibara;2022;abr;366758119;174801071;191957048;133577040;58380008;13;18;864;2238;2860;Baja
Zonas Secundarias;Medellin Nutibara;2022;may;436345666;232764055;203581611;135986745;67594866;13;18;924;2522;2950;Baja
Zonas Secundarias;Medellin Nutibara;2022;jun;419346634;202380273;216966361;159933928;57032433;15;18;877;2551;2950;Baja
Zonas Secundarias;Medellin Nutibara;2022;jul;348652595;189396893;159255702;133564733;25690969;14;19;633;2168;2950;Baja
Zonas Secundarias;Medellin Nutibara;2022;ago;377381885;208155537;169226348;142774935;26451413;14;20;587;1940;2950;Baja
Zonas Secundarias;Medellin Nutibara;2022;sep;365031086;202915060;162116026;134840613;27275413;14;20;573;1912;2950;Baja
Zonas Secundarias;Medellin Nutibara;2022;oct;362027359;183096897;178930462;121108109;57822353;15;20;551;1640;2950;Baja
Zonas Secundarias;Medellin Nutibara;2022;nov;335482167;186794380;148687787;141576808;7110979;16;18;565;1687;2950;Baja
Zonas Secundarias;Medellin Nutibara;2022;dic;459605584;226430906;233174678;175094090;58080588;14;21;709;2341;2950;Baja
Zonas Secundarias;Medellin Nutibara;2023;ene;378411826;190108868;188302958;136985964;51316994;15;20;600;1735;2950;Baja
Zonas Secundarias;Medellin Nutibara;2023;feb;330799993;180037498;150762495;147203371;3559124;13;20;496;1570;2950;Baja
Zonas Secundarias;Medellin Nutibara;2023;mar;397108022;225112585;171995437;202018444;-30023007;14;21;580;1826;3110;Perdida
Zonas Secundarias;Medellin Nutibara;2023;abr;314340914;176807592;137533322;176795052;-39261730;15;20;462;1513;2950;Perdida
Zonas Secundarias;Medellin Nutibara;2023;may;446260216;256345109;189915107;182259918;7655189;15;19;543;2001;2790;Baja
Zonas Secundarias;Medellin Nutibara;2023;jun;353815621;197417738;156397883;198244272;-41846389;16;18;470;1583;2790;Perdida
Zonas Secundarias;Medellin Nutibara;2023;jul;331499091;177840337;153658754;154700689;-1041935;16;17;453;1537;2630;Perdida
Zonas Secundarias;Medellin Nutibara;2023;ago;445949612;221508555;224441057;161817081;62623976;15;16;532;2029;2310;Baja
Zonas Secundarias;Medellin Nutibara;2023;sep;297250563;137544342;159706221;145004484;14701737;15;16;363;1211;2310;Baja
Zonas Secundarias;Medellin Nutibara;2023;oct;379404908;197752546;181652362;181781651;-129289;15;16;460;1624;2310;Perdida
Zonas Secundarias;Medellin Nutibara;2023;nov;313511969;169707432;143804537;153996871;-10192334;13;15;426;1323;2150;Perdida
Zonas Secundarias;Medellin Nutibara;2023;dic;465610133;208800267;256809866;143899902;112909964;13;15;552;1939;2150;Media
Zonas Secundarias;Medellin Nutibara;2024;ene;383806075;183759981;200046094;143581857;56464237;13;14;450;1680;2150;Baja
Zonas Secundarias;Medellin Nutibara;2024;feb;414034043;224426504;189607539;178067466;11540073;15;15;466;1706;2470;Baja
Zonas Secundarias;Medellin Nutibara;2024;mar;299274463;166546970;132727493;155078914;-22351421;14;15;381;1289;2470;Perdida
Zonas Secundarias;Medellin Nutibara;2024;abr;355528469;182101171;173427298;163904663;9522635;13;14;432;1425;2310;Baja
Zonas Secundarias;Medellin Nutibara;2024;may;374327034;193459183;180867851;146895564;33972287;13;14;451;1522;2310;Baja
Zonas Secundarias;Medellin Nutibara;2024;jun;367990277;169084475;198905802;160205977;38699825;14;14;385;1258;2310;Baja
Zonas Secundarias;Medellin Nutibara;2024;jul;357281397;197532424;159748973;154048593;5700380;15;14;450;1439;2310;Baja
Zonas Secundarias;Medellin Nutibara;2024;ago;407295398;223099709;184195689;153727276;30468413;14;14;481;1680;2310;Baja
Zonas Secundarias;Medellin Nutibara;2024;sep;370511184;196523874;173987310;153085328;20901982;13;16;456;1538;2470;Baja
Zonas Secundarias;Medellin Nutibara;2024;oct;420848944;203381467;217467477;145981262;71486215;13;16;502;1784;2470;Baja
Zonas Secundarias;Medellin Nutibara;2024;nov;365383435;188004823;177378612;182440763;-5062151;13;16;393;1536;2470;Perdida
Zonas Secundarias;Medellin Nutibara;2024;dic;485079355;249132442;235946913;207992103;27954810;13;16;534;1987;2470;Baja
Zonas Secundarias;Medellin Poblado;2021;ene;171821985;68460345;103361640;62026391;41335249;5;11;414;1031;1370;Media
Zonas Secundarias;Medellin Poblado;2021;feb;177322922;71963494;105359428;75039473;30319955;5;12;408;1068;1530;Baja
Zonas Secundarias;Medellin Poblado;2021;mar;212408357;92664539;119743818;74750680;44993138;5;12;505;1281;1530;Baja
Zonas Secundarias;Medellin Poblado;2021;abr;127499740;75939220;51560520;80601067;-29040547;5;12;279;709;1530;Perdida
Zonas Secundarias;Medellin Poblado;2021;may;137638458;67787339;69851119;71969365;-2118246;5;11;321;808;1530;Perdida
Zonas Secundarias;Medellin Poblado;2021;jun;173087396;74673982;98413414;73838490;24574924;5;8;431;1059;1370;Baja
Zonas Secundarias;Medellin Poblado;2021;jul;194887624;80535153;114352471;78959277;35393194;5;8;500;1126;1370;Baja
Zonas Secundarias;Medellin Poblado;2021;ago;226152839;95956213;130196626;88784599;41412027;5;9;471;1272;1530;Baja
Zonas Secundarias;Medellin Poblado;2021;sep;226136924;105355902;120781022;84693459;36087563;5;9;439;1256;1530;Baja
Zonas Secundarias;Medellin Poblado;2021;oct;196249672;75297822;120951850;72832864;48118986;5;8;445;1175;1370;Media
Zonas Secundarias;Medellin Poblado;2021;nov;236494047;85965072;150528975;86534267;63994708;5;9;496;1444;1530;Media
Zonas Secundarias;Medellin Poblado;2021;dic;246206087;94145498;152060589;93894975;58165614;4;9;537;1456;1530;Media
Zonas Secundarias;Medellin Poblado;2022;ene;195371340;89045211;106326129;86182038;20144091;4;10;463;1108;1530;Baja
Zonas Secundarias;Medellin Poblado;2022;feb;185761446;86401350;99360096;87047078;12313018;5;10;451;1079;1530;Baja
Zonas Secundarias;Medellin Poblado;2022;mar;255409956;98117399;157292557;80699787;76592770;5;10;507;1443;1530;Media
Zonas Secundarias;Medellin Poblado;2022;abr;203138182;88417379;114720803;118587854;-3867051;5;9;456;1092;1530;Perdida
Zonas Secundarias;Medellin Poblado;2022;may;193899066;82303744;111595322;91579117;20016205;5;9;444;1069;1440;Baja
Zonas Secundarias;Medellin Poblado;2022;jun;190644029;81918018;108726011;92639384;16086627;5;9;408;1047;1440;Baja
Zonas Secundarias;Medellin Poblado;2022;jul;216535371;102600337;113935034;91353469;22581565;4;9;472;1116;1440;Baja
Zonas Secundarias;Medellin Poblado;2022;ago;225414726;102954438;122460288;101614018;20846270;4;9;463;1098;1440;Baja
Zonas Secundarias;Medellin Poblado;2022;sep;223145833;101249762;121896071;84486741;37409330;4;8;458;1115;1280;Baja
Zonas Secundarias;Medellin Poblado;2022;oct;224961175;92146581;132814594;76279848;56534746;5;8;430;1055;1280;Media
Zonas Secundarias;Medellin Poblado;2022;nov;234461102;93749769;140711333;93319433;47391900;6;8;457;1138;1280;Baja
Zonas Secundarias;Medellin Poblado;2022;dic;267489529;102944011;164545518;99145088;65400430;5;8;567;1314;1280;Media
Zonas Secundarias;Medellin Poblado;2023;ene;239003518;94037347;144966171;94013118;50953053;4;8;489;1148;1280;Baja
Zonas Secundarias;Medellin Poblado;2023;feb;219185212;90528878;128656334;96162662;32493672;4;8;401;1049;1280;Baja
Zonas Secundarias;Medellin Poblado;2023;mar;205562846;91318147;114244699;96682812;17561887;4;8;414;961;1280;Baja
Zonas Secundarias;Medellin Poblado;2023;abr;217836113;88312709;129523404;91224712;38298692;5;8;389;1038;1280;Baja
Zonas Secundarias;Medellin Poblado;2023;may;225813123;100579779;125233344;92047318;33186026;5;9;402;1096;1280;Baja
Zonas Secundarias;Medellin Poblado;2023;jun;227766296;102241162;125525134;115228774;10296360;5;9;423;983;1280;Baja
Zonas Secundarias;Medellin Poblado;2023;jul;198930748;83953108;114977640;100034478;14943162;5;9;401;962;1280;Baja
Zonas Secundarias;Medellin Poblado;2023;ago;222664345;97821925;124842420;113431177;11411243;6;8;447;1084;1120;Baja
Zonas Secundarias;Medellin Poblado;2023;sep;222823147;83634839;139188308;116988376;22199932;5;8;433;1038;1120;Baja
Zonas Secundarias;Medellin Poblado;2023;oct;178126296;81982351;96143945;110133887;-13989942;5;8;388;822;1120;Perdida
Zonas Secundarias;Medellin Poblado;2023;nov;199915521;88257455;111658066;110128661;1529405;5;7;411;938;1120;Perdida
Zonas Secundarias;Medellin Poblado;2023;dic;234480661;85151169;149329492;93339304;55990188;5;7;425;1098;1120;Media
Zonas Secundarias;Medellin Poblado;2024;ene;209674836;85427710;124247126;99396968;24850158;5;7;401;891;1120;Baja
Zonas Secundarias;Medellin Poblado;2024;feb;198187573;87966492;110221081;126715958;-16494877;5;6;356;874;960;Perdida
Zonas Secundarias;Medellin Poblado;2024;mar;187879536;78016148;109863388;105010503;4852885;5;5;361;812;800;Baja
Zonas Secundarias;Medellin Poblado;2024;abr;275856187;96324089;179532098;107842357;71689741;5;5;387;1080;800;Media
Zonas Secundarias;Medellin Poblado;2024;may;286235784;117344648;168891136;100555434;68335702;4;5;364;1148;800;Media
Zonas Secundarias;Medellin Poblado;2024;jun;280959127;121713451;159245676;105665077;53580599;4;7;362;1046;1120;Baja
Zonas Secundarias;Medellin Poblado;2024;jul;308814422;121041475;187772947;112376002;75396945;4;8;422;1209;1120;Media
Zonas Secundarias;Medellin Poblado;2024;ago;276483182;115327856;161155326;138377456;22777870;4;8;384;1085;1120;Baja
Zonas Secundarias;Medellin Poblado;2024;sep;290481073;124967887;165513186;89314096;76199090;4;8;361;1132;1120;Media
Zonas Secundarias;Medellin Poblado;2024;oct;285710797;108386095;177324702;93724321;83600381;4;8;375;1150;1120;Media
Zonas Secundarias;Medellin Poblado;2024;nov;242112614;92635243;149477371;118718994;30758377;4;9;332;945;1120;Baja
Zonas Secundarias;Medellin Poblado;2024;dic;314916837;121127182;193789655;108770424;85019231;5;9;398;1208;1120;Media
Zonas Secundarias;Vegas;2021;ene;232330017;90615249;141714768;93194266;48520502;8;13;558;1273;1670;Baja
Zonas Secundarias;Vegas;2021;feb;258782619;116717510;142065109;116008793;26056316;9;13;605;1363;1670;Baja
Zonas Secundarias;Vegas;2021;mar;285986059;132689456;153296603;108464464;44832139;10;14;708;1580;1830;Baja
Zonas Secundarias;Vegas;2021;abr;156771271;99142566;57628705;111142038;-53513333;10;13;417;878;1580;Perdida
Zonas Secundarias;Vegas;2021;may;183399557;99357847;84041710;108683556;-24641846;10;11;473;1044;1580;Perdida
Zonas Secundarias;Vegas;2021;jun;221878669;105989914;115888755;119288175;-3399420;8;10;571;1273;1580;Perdida
Zonas Secundarias;Vegas;2021;jul;265649326;127298136;138351190;115492969;22858221;8;14;661;1460;1740;Baja
Zonas Secundarias;Vegas;2021;ago;277548103;128198353;149349750;104812164;44537586;8;14;680;1597;1740;Baja
Zonas Secundarias;Vegas;2021;sep;282744439;135910641;146833798;149915373;-3081575;9;16;677;1603;2060;Perdida
Zonas Secundarias;Vegas;2021;oct;281262190;144383312;136878878;114773593;22105285;10;16;710;1519;2060;Baja
Zonas Secundarias;Vegas;2021;nov;273408637;136788096;136620541;117515057;19105484;10;16;653;1443;2060;Baja
Zonas Secundarias;Vegas;2021;dic;313520487;138067171;175453316;140016642;35436674;10;14;772;1717;1830;Baja
Zonas Secundarias;Vegas;2022;ene;284493706;123315708;161177998;126919912;34258086;9;11;669;1487;1830;Baja
Zonas Secundarias;Vegas;2022;feb;263123381;118168030;144955351;127800460;17154891;9;13;658;1451;2150;Baja
Zonas Secundarias;Vegas;2022;mar;303944813;137019646;166925167;94826570;72098597;9;13;682;1524;2150;Media
Zonas Secundarias;Vegas;2022;abr;297298827;129427420;167871407;108982069;58889338;9;13;664;1510;2150;Baja
Zonas Secundarias;Vegas;2022;may;279105449;132427720;146677729;135525574;11152155;10;13;641;1415;2150;Baja
Zonas Secundarias;Vegas;2022;jun;271755338;130321517;141433821;122173027;19260794;10;13;693;1392;2150;Baja
Zonas Secundarias;Vegas;2022;jul;250907002;122646350;128260652;128985767;-725115;12;12;604;1293;1990;Perdida
Zonas Secundarias;Vegas;2022;ago;330795699;136136514;194659185;137999110;56660075;11;12;757;1680;1990;Baja
Zonas Secundarias;Vegas;2022;sep;549282274;365595083;183687191;162485473;21201718;11;12;739;1618;1990;Baja
Zonas Secundarias;Vegas;2022;oct;316893491;125643595;191249896;130026463;61223433;11;12;670;1610;1990;Baja
Zonas Secundarias;Vegas;2022;nov;318372009;114673860;203698149;138608187;65089962;11;12;743;1698;1990;Baja
Zonas Secundarias;Vegas;2022;dic;359032545;140470564;218561981;159259240;59302741;11;12;782;1859;1990;Baja
Zonas Secundarias;Vegas;2023;ene;325506124;126911215;198594909;156235829;42359080;11;11;722;1621;1830;Baja
Zonas Secundarias;Vegas;2023;feb;310339533;122300907;188038626;144479727;43558899;10;11;617;1545;1830;Baja
Zonas Secundarias;Vegas;2023;mar;375001791;159468070;215533721;124803511;90730210;9;13;761;1798;2150;Media
Zonas Secundarias;Vegas;2023;abr;309344649;141834748;167509901;137575682;29934219;10;13;610;1418;2150;Baja
Zonas Secundarias;Vegas;2023;may;358826315;192321868;166504447;142561999;23942448;10;14;694;1586;2310;Baja
Zonas Secundarias;Vegas;2023;jun;322865793;165926750;156939043;165095019;-8155976;11;14;600;1358;2310;Perdida
Zonas Secundarias;Vegas;2023;jul;350313594;183354467;166959127;156010745;10948382;12;14;625;1462;2310;Baja
Zonas Secundarias;Vegas;2023;ago;331831357;169198821;162632536;113012921;49619615;10;13;635;1446;1990;Baja
Zonas Secundarias;Vegas;2023;sep;375765169;185710128;190055041;112543776;77511265;9;13;682;1532;1990;Baja
Zonas Secundarias;Vegas;2023;oct;351136743;191538821;159597922;166848207;-7250285;11;12;563;1352;1990;Perdida
Zonas Secundarias;Vegas;2023;nov;309386468;162201470;147184998;161658061;-14473063;10;12;557;1231;1990;Perdida
Zonas Secundarias;Vegas;2023;dic;390140447;174675983;215464464;147412717;68051747;10;11;725;1488;1690;Baja
Zonas Secundarias;Vegas;2024;ene;416256591;187634056;228622535;139419099;89203436;7;10;692;1575;1530;Baja
Zonas Secundarias;Vegas;2024;feb;386557378;187739185;198818193;152166960;46651233;10;14;585;1452;2010;Baja
Zonas Secundarias;Vegas;2024;mar;338355343;203781867;134573476;140743868;-6170392;10;14;552;1221;2010;Perdida
Zonas Secundarias;Vegas;2024;abr;369813601;200715606;169097995;148351172;20746823;9;14;640;1381;2010;Baja
Zonas Secundarias;Vegas;2024;may;444990547;208784469;236206078;168681608;67524470;11;14;624;1644;2010;Baja
Zonas Secundarias;Vegas;2024;jun;365246054;193441819;171804235;187212540;-15408305;11;15;550;1302;2170;Perdida
Zonas Secundarias;Vegas;2024;jul;416938106;204747740;212190366;166529779;45660587;12;14;614;1549;2010;Baja
Zonas Secundarias;Vegas;2024;ago;425253460;223591133;201662327;168912124;32750203;11;16;599;1549;2470;Baja
Zonas Secundarias;Vegas;2024;sep;415855712;218678447;197177265;157754183;39423082;8;16;587;1509;2330;Baja
Zonas Secundarias;Vegas;2024;oct;438961535;207478137;231483398;125287604;106195794;8;15;653;1620;2170;Media
Zonas Secundarias;Vegas;2024;nov;400775517;221024872;179750645;142828754;36921891;8;15;585;1399;2170;Baja
Zonas Secundarias;Vegas;2024;dic;468524323;228521183;240003140;170524861;69478279;8;14;627;1535;2010;Baja
Zona Bogota;Bogota Calle 13;2021;ene;299325646;217801551;81524095;163598274;-82074179;14;32;521;1676;4410;Perdida
Zona Bogota;Bogota Calle 13;2021;feb;462791315;325086290;137705025;202795097;-65090072;15;32;808;2271;4410;Perdida
Zona Bogota;Bogota Calle 13;2021;mar;695122706;329714510;365408196;212792547;152615649;14;31;973;2919;4250;Baja
Zona Bogota;Bogota Calle 13;2021;abr;247412027;213307642;34104385;88635346;-54530961;15;30;606;2104;4410;Perdida
Zona Bogota;Bogota Calle 13;2021;may;407532934;245882260;161650674;179129477;-17478803;16;30;635;2101;4410;Perdida
Zona Bogota;Bogota Calle 13;2021;jun;489018742;283387527;205631215;202105026;3526189;15;30;787;2604;4410;Perdida
Zona Bogota;Bogota Calle 13;2021;jul;546758579;310991028;235767551;187094426;48673125;15;35;872;2879;4410;Baja
Zona Bogota;Bogota Calle 13;2021;ago;524375357;287257696;237117661;190259070;46858591;16;35;890;3009;4410;Baja
Zona Bogota;Bogota Calle 13;2021;sep;567222938;306999238;260223700;192540419;67683281;15;34;961;3141;4570;Baja
Zona Bogota;Bogota Calle 13;2021;oct;572954329;304804316;268150013;216556627;51593386;18;34;896;3201;4250;Baja
Zona Bogota;Bogota Calle 13;2021;nov;517000028;260779655;256220373;213983530;42236843;18;36;805;2792;4570;Baja
Zona Bogota;Bogota Calle 13;2021;dic;666669569;297171409;369498160;275096585;94401575;18;36;1089;3809;4570;Baja
Zona Bogota;Bogota Calle 13;2022;ene;501141914;267716143;233425771;246760875;-13335104;18;37;864;2745;4570;Perdida
Zona Bogota;Bogota Calle 13;2022;feb;538485479;275314129;263171350;221076624;42094726;18;37;811;2915;4570;Baja
Zona Bogota;Bogota Calle 13;2022;mar;604561302;312858470;291702832;230498219;61204613;16;36;901;3273;4570;Baja
Zona Bogota;Bogota Calle 13;2022;abr;554629408;323271706;231357702;249041882;-17684180;17;34;809;2921;4570;Perdida
Zona Bogota;Bogota Calle 13;2022;may;528664232;255188577;273475655;236080671;37394984;17;34;810;2885;4570;Baja
Zona Bogota;Bogota Calle 13;2022;jun;614100445;304550703;309549742;231388727;78161015;17;35;839;3096;4570;Baja
Zona Bogota;Bogota Calle 13;2022;jul;652737798;313888782;338849016;231718192;107130824;17;32;919;3164;4410;Baja
Zona Bogota;Bogota Calle 13;2022;ago;610221391;286688795;323532596;225222208;98310388;17;33;858;3090;4410;Baja
Zona Bogota;Bogota Calle 13;2022;sep;615791879;294544043;321247836;235410996;85836840;18;30;796;3212;4410;Baja
Zona Bogota;Bogota Calle 13;2022;oct;485631160;268790911;216840249;213815335;3024914;18;28;740;2493;4250;Perdida
Zona Bogota;Bogota Calle 13;2022;nov;619027891;300506009;318521882;249727570;68794312;22;26;753;2919;4250;Baja
Zona Bogota;Bogota Calle 13;2022;dic;709616194;310480319;399135875;237946735;161189140;19;29;941;3383;4250;Media
Zona Bogota;Bogota Calle 13;2023;ene;549910526;257519676;292390850;234369567;58021283;17;30;781;2563;4250;Baja
Zona Bogota;Bogota Calle 13;2023;feb;482424665;267852266;214572399;268590040;-54017641;19;29;678;2225;4250;Perdida
Zona Bogota;Bogota Calle 13;2023;mar;555252767;293765872;261486895;293545556;-32058661;20;29;721;2447;4090;Perdida
Zona Bogota;Bogota Calle 13;2023;abr;534509096;299714949;234794147;326140854;-91346707;20;27;665;2215;3930;Perdida
Zona Bogota;Bogota Calle 13;2023;may;636242763;326567475;309675288;252716534;56958754;19;27;742;2855;3930;Baja
Zona Bogota;Bogota Calle 13;2023;jun;616153948;317596715;298557233;320710522;-22153289;19;25;766;2456;3770;Perdida
Zona Bogota;Bogota Calle 13;2023;jul;572278057;322436907;249841150;282807701;-32966551;22;28;735;2385;4230;Perdida
Zona Bogota;Bogota Calle 13;2023;ago;648026973;226534312;421492661;361906799;59585862;22;28;841;2816;4230;Baja
Zona Bogota;Bogota Calle 13;2023;sep;607767163;243798955;363968208;227884415;136083793;20;29;750;2823;4070;Media
Zona Bogota;Bogota Calle 13;2023;oct;567777622;330338362;237439260;256968279;-19529019;21;29;723;2458;4230;Perdida
Zona Bogota;Bogota Calle 13;2023;nov;684431572;357437722;326993850;177674159;149319691;21;28;767;2928;4070;Baja
Zona Bogota;Bogota Calle 13;2023;dic;570883505;395472859;175410646;201270220;-25859574;20;27;968;3106;3910;Perdida
Zona Bogota;Bogota Calle 13;2024;ene;580535591;295989201;284546390;278347357;6199033;18;27;709;2373;3750;Baja
Zona Bogota;Bogota Calle 13;2024;feb;594370184;322580488;271789696;369051046;-97261350;21;29;1005;2517;4070;Perdida
Zona Bogota;Bogota Calle 13;2024;mar;550169838;330464486;219705352;254588298;-34882946;20;29;656;2186;4070;Perdida
Zona Bogota;Bogota Calle 13;2024;abr;657020655;350087803;306932852;168822112;138110740;19;29;720;2544;4070;Baja
Zona Bogota;Bogota Calle 13;2024;may;693700524;352959940;340740584;297445267;43295317;19;29;679;2883;4070;Baja
Zona Bogota;Bogota Calle 13;2024;jun;632230522;342274073;289956449;233299027;56657422;18;29;683;2538;4230;Baja
Zona Bogota;Bogota Calle 13;2024;jul;663029832;350519743;312510089;256125400;56384689;18;29;714;2702;4230;Baja
Zona Bogota;Bogota Calle 13;2024;ago;675908094;366582294;309325800;239141062;70184738;17;29;691;2639;4230;Baja
Zona Bogota;Bogota Calle 13;2024;sep;643737779;332983407;310754372;255917351;54837021;16;28;623;2394;4070;Baja
Zona Bogota;Bogota Calle 13;2024;oct;718268408;332725677;385542731;214887368;170655363;15;26;754;2776;3910;Media
Zona Bogota;Bogota Calle 13;2024;nov;837252987;404244074;433008913;262576603;170432310;16;27;697;3310;3910;Baja
Zona Bogota;Bogota Calle 13;2024;dic;780448736;344307695;436141041;321821318;114319723;16;26;780;2739;3750;Baja
Zona Bogota;Bogota Calle 13 Colision;2021;ene;136909856;55768531;81141325;70679416;10461909;5;7;72;1517;1200;Baja
Zona Bogota;Bogota Calle 13 Colision;2021;feb;137511387;53559505;83951882;58976833;24975049;5;7;108;1339;1200;Baja
Zona Bogota;Bogota Calle 13 Colision;2021;mar;145517713;72639887;72877826;64546332;8331494;5;8;103;1408;1360;Baja
Zona Bogota;Bogota Calle 13 Colision;2021;abr;107914795;64824214;43090581;60984353;-17893772;5;8;90;1146;1360;Perdida
Zona Bogota;Bogota Calle 13 Colision;2021;may;124619951;69425186;55194765;61950532;-6755767;5;8;90;1208;1360;Perdida
Zona Bogota;Bogota Calle 13 Colision;2021;jun;130762273;78532496;52229777;68434824;-16205047;4;8;108;1335;1360;Perdida
Zona Bogota;Bogota Calle 13 Colision;2021;jul;175323866;84949063;90374803;62043378;28331425;4;8;136;1797;1360;Baja
Zona Bogota;Bogota Calle 13 Colision;2021;ago;165298745;81437920;83860825;58909291;24951534;4;9;125;1678;1560;Baja
Zona Bogota;Bogota Calle 13 Colision;2021;sep;177600232;85273888;92326344;68108797;24217547;4;9;146;1712;1560;Baja
Zona Bogota;Bogota Calle 13 Colision;2021;oct;175678489;81556900;94121589;73584579;20537010;4;9;124;1835;1560;Baja
Zona Bogota;Bogota Calle 13 Colision;2021;nov;161104190;91821590;69282600;67002805;2279795;4;9;129;1679;1560;Baja
Zona Bogota;Bogota Calle 13 Colision;2021;dic;200796534;94272000;106524534;72829360;33695174;4;9;158;1960;1560;Baja
Zona Bogota;Bogota Calle 13 Colision;2022;ene;182442842;91734080;90708762;59131521;31577241;4;8;134;2016;1360;Baja
Zona Bogota;Bogota Calle 13 Colision;2022;feb;194558477;82998650;111559827;58253797;53306030;4;8;142;1945;1360;Media
Zona Bogota;Bogota Calle 13 Colision;2022;mar;172219576;81175751;91043825;55843045;35200780;3;8;143;1840;1360;Baja
Zona Bogota;Bogota Calle 13 Colision;2022;abr;139000186;91800672;47199514;49123485;-1923971;3;11;125;1336;1880;Perdida
Zona Bogota;Bogota Calle 13 Colision;2022;may;176613108;99616577;76996531;57879444;19117087;3;11;140;1775;1880;Baja
Zona Bogota;Bogota Calle 13 Colision;2022;jun;138924297;82019584;56904713;49031187;7873526;3;11;99;1391;1880;Baja
Zona Bogota;Bogota Calle 13 Colision;2022;jul;179005026;97046871;81958155;53915182;28042973;3;9;131;1682;1520;Baja
Zona Bogota;Bogota Calle 13 Colision;2022;ago;168463993;91307137;77156856;51454388;25702468;3;9;121;1607;1520;Baja
Zona Bogota;Bogota Calle 13 Colision;2022;sep;203213559;113979786;89233773;57580319;31653454;4;9;141;1968;1520;Baja
Zona Bogota;Bogota Calle 13 Colision;2022;oct;164870592;84108156;80762436;83469146;-2706710;4;9;116;1513;1520;Perdida
Zona Bogota;Bogota Calle 13 Colision;2022;nov;136293533;58266735;78026798;57614559;20412239;5;9;111;1186;1520;Baja
Zona Bogota;Bogota Calle 13 Colision;2022;dic;168846113;129933831;38912282;54859373;-15947091;6;14;152;1321;2360;Perdida
Zona Bogota;Bogota Calle 13 Colision;2023;ene;169493981;94138748;75355233;78964151;-3608918;6;14;106;1598;2360;Perdida
Zona Bogota;Bogota Calle 13 Colision;2023;feb;180692846;122795057;57897789;68442391;-10544602;6;14;126;1692;2360;Perdida
Zona Bogota;Bogota Calle 13 Colision;2023;mar;181983714;117388428;64595286;75757733;-11162447;7;13;123;1568;2160;Perdida
Zona Bogota;Bogota Calle 13 Colision;2023;abr;134555983;133204772;1351211;74987689;-73636478;7;12;90;1157;1960;Perdida
Zona Bogota;Bogota Calle 13 Colision;2023;may;175385231;105865315;69519916;67866882;1653034;7;12;100;1517;1960;Perdida
Zona Bogota;Bogota Calle 13 Colision;2023;jun;196914355;130116718;66797637;73702908;-6905271;7;12;121;1589;1960;Perdida
Zona Bogota;Bogota Calle 13 Colision;2023;jul;181429110;99184329;82244781;78469120;3775661;7;12;117;1664;1960;Baja
Zona Bogota;Bogota Calle 13 Colision;2023;ago;158128961;91112211;67016750;69068260;-2051510;7;11;94;1386;1840;Perdida
Zona Bogota;Bogota Calle 13 Colision;2023;sep;152034701;80181381;71853320;62632613;9220707;6;11;118;1321;1840;Baja
Zona Bogota;Bogota Calle 13 Colision;2023;oct;168989677;95479581;73510096;65063474;8446622;6;10;114;1562;1680;Baja
Zona Bogota;Bogota Calle 13 Colision;2023;nov;181274477;87003529;94270948;68148579;26122369;6;10;107;1683;1680;Baja
Zona Bogota;Bogota Calle 13 Colision;2023;dic;204861133;81512406;123348727;63218279;60130448;6;10;120;1484;1680;Media
Zona Bogota;Bogota Calle 13 Colision;2024;ene;172499688;109552235;62947453;81277321;-18329868;6;10;92;1660;1680;Perdida
Zona Bogota;Bogota Calle 13 Colision;2024;feb;143736965;79032295;64704670;64037379;667291;6;10;96;1270;1680;Perdida
Zona Bogota;Bogota Calle 13 Colision;2024;mar;200535898;110612699;89923199;80703930;9219269;6;10;113;1673;1680;Baja
Zona Bogota;Bogota Calle 13 Colision;2024;abr;181903556;99640434;82263122;75962780;6300342;6;9;121;1440;1480;Baja
Zona Bogota;Bogota Calle 13 Colision;2024;may;126677291;97627035;29050256;75659203;-46608947;6;9;83;1167;1480;Perdida
Zona Bogota;Bogota Calle 13 Colision;2024;jun;143496059;74068940;69427119;77261122;-7834003;5;9;86;1231;1480;Perdida
Zona Bogota;Bogota Calle 13 Colision;2024;jul;136522305;114680360;21841945;57444734;-35602789;4;9;78;1134;1480;Perdida
Zona Bogota;Bogota Calle 13 Colision;2024;ago;199825493;120183282;79642211;65633780;14008431;4;9;94;1818;1480;Baja
Zona Bogota;Bogota Calle 13 Colision;2024;sep;209404662;116278152;93126510;59875774;33250736;6;9;94;1750;1560;Baja
Zona Bogota;Bogota Calle 13 Colision;2024;oct;214773697;94929083;119844614;60591369;59253245;6;8;98;1802;1400;Media
Zona Bogota;Bogota Calle 13 Colision;2024;nov;232721867;110046394;122675473;69383995;53291478;6;8;103;1917;1400;Media
Zona Bogota;Bogota Calle 13 Colision;2024;dic;182775509;107727749;75047760;73149138;1898622;6;8;107;1406;1400;Baja
Zona Bogota;Bogota Calle 153;2021;ene;99074629;62635425;36439204;90942481;-54503277;5;10;216;570;1640;Perdida
Zona Bogota;Bogota Calle 153;2021;feb;185501307;84691484;100809823;55914897;44894926;5;10;388;1067;1640;Media
Zona Bogota;Bogota Calle 153;2021;mar;198100930;89535208;108565722;75759760;32805962;5;10;459;1077;1640;Baja
Zona Bogota;Bogota Calle 153;2021;abr;122432068;73251776;49180292;98108715;-48928423;5;10;243;679;1640;Perdida
Zona Bogota;Bogota Calle 153;2021;may;164960154;83849621;81110533;96461419;-15350886;5;10;325;888;1640;Perdida
Zona Bogota;Bogota Calle 153;2021;jun;189472513;91879492;97593021;99783053;-2190032;5;10;377;1086;1640;Perdida
Zona Bogota;Bogota Calle 153;2021;jul;202784464;100474393;102310071;98025567;4284504;5;11;449;1028;1640;Baja
Zona Bogota;Bogota Calle 153;2021;ago;232413645;103807324;128606321;103667951;24938370;5;11;476;1218;1640;Baja
Zona Bogota;Bogota Calle 153;2021;sep;232006041;105810004;126196037;110366763;15829274;5;11;505;1269;1640;Baja
Zona Bogota;Bogota Calle 153;2021;oct;228249314;111711496;116537818;134183733;-17645915;5;11;495;1202;1640;Perdida
Zona Bogota;Bogota Calle 153;2021;nov;226208155;106151488;120056667;95183797;24872870;5;11;502;1130;1640;Baja
Zona Bogota;Bogota Calle 153;2021;dic;284951544;107877963;177073581;116966060;60107521;5;11;611;1513;1640;Baja
Zona Bogota;Bogota Calle 153;2022;ene;245050555;106926531;138124024;94759394;43364630;5;11;421;1273;1640;Baja
Zona Bogota;Bogota Calle 153;2022;feb;213066832;98701164;114365668;100214145;14151523;5;10;421;1146;1640;Baja
Zona Bogota;Bogota Calle 153;2022;mar;213020635;99024819;113995816;104301668;9694148;5;10;433;1116;1640;Baja
Zona Bogota;Bogota Calle 153;2022;abr;228056759;109967507;118089252;106444344;11644908;5;10;441;1090;1640;Baja
Zona Bogota;Bogota Calle 153;2022;may;214712317;103278821;111433496;108602261;2831235;5;10;432;1103;1640;Baja
Zona Bogota;Bogota Calle 153;2022;jun;208998197;94601480;114396717;110765180;3631537;5;10;423;1126;1640;Baja
Zona Bogota;Bogota Calle 153;2022;jul;245343578;119201468;126142110;111889821;14252289;5;11;444;1229;1640;Baja
Zona Bogota;Bogota Calle 153;2022;ago;244851682;103083765;141767917;105733122;36034795;5;11;422;1277;1640;Baja
Zona Bogota;Bogota Calle 153;2022;sep;242360697;96187794;146172903;109236062;36936841;6;10;400;1243;1440;Baja
Zona Bogota;Bogota Calle 153;2022;oct;241198798;101427182;139771616;124902281;14869335;6;10;406;1196;1440;Baja
Zona Bogota;Bogota Calle 153;2022;nov;219934005;88374911;131559094;131328255;230839;8;8;409;1216;1280;Perdida
Zona Bogota;Bogota Calle 153;2022;dic;264227777;102699546;161528231;149216882;12311349;6;10;510;1289;1440;Baja
Zona Bogota;Bogota Calle 153;2023;ene;197185816;89968748;107217068;113230740;-6013672;7;10;393;952;1440;Perdida
Zona Bogota;Bogota Calle 153;2023;feb;223258417;90472237;132786180;86981672;45804508;7;11;373;1106;1600;Baja
Zona Bogota;Bogota Calle 153;2023;mar;246351898;112068160;134283738;120934395;13349343;7;10;405;1110;1440;Baja
Zona Bogota;Bogota Calle 153;2023;abr;236398946;100349854;136049092;106240237;29808855;8;11;385;1068;1600;Baja
Zona Bogota;Bogota Calle 153;2023;may;216217821;105179906;111037915;110974428;63487;8;11;358;982;1600;Perdida
Zona Bogota;Bogota Calle 153;2023;jun;233149318;110795275;122354043;135771763;-13417720;8;10;383;979;1440;Perdida
Zona Bogota;Bogota Calle 153;2023;jul;236283341;108081163;128202178;116705546;11496632;8;10;406;1068;1440;Baja
Zona Bogota;Bogota Calle 153;2023;ago;246400603;107634991;138765612;136338089;2427523;7;9;476;1097;1280;Perdida
Zona Bogota;Bogota Calle 153;2023;sep;186155967;85460047;100695920;106836592;-6140672;8;8;355;801;1120;Perdida
Zona Bogota;Bogota Calle 153;2023;oct;219973131;109407581;110565550;153080352;-42514802;9;6;374;908;960;Perdida
Zona Bogota;Bogota Calle 153;2023;nov;211600060;93872286;117727774;132039191;-14311417;9;6;398;895;960;Perdida
Zona Bogota;Bogota Calle 153;2023;dic;309806277;108492585;201313692;150054557;51259135;8;6;485;1133;960;Baja
Zona Bogota;Bogota Calle 153;2024;ene;231189600;98385979;132803621;129486834;3316787;8;7;386;1020;1120;Baja
Zona Bogota;Bogota Calle 153;2024;feb;232230696;94031911;138198785;137370526;828259;9;8;358;969;1280;Perdida
Zona Bogota;Bogota Calle 153;2024;mar;225702234;105213383;120488851;148606902;-28118051;10;8;373;961;1280;Perdida
Zona Bogota;Bogota Calle 153;2024;abr;244969088;110862783;134106305;141727023;-7620718;9;8;385;946;1280;Perdida
Zona Bogota;Bogota Calle 153;2024;may;255571367;115102972;140468395;142718868;-2250473;9;8;368;1009;1280;Perdida
Zona Bogota;Bogota Calle 153;2024;jun;212106882;101982847;110124035;223002139;-112878104;9;8;349;806;1280;Perdida
Zona Bogota;Bogota Calle 153;2024;jul;248900031;106024870;142875161;167967816;-25092655;9;8;372;988;1280;Perdida
Zona Bogota;Bogota Calle 153;2024;ago;241507351;110146540;131360811;201105042;-69744231;9;8;404;954;1280;Perdida
Zona Bogota;Bogota Calle 153;2024;sep;229378226;102439203;126939023;147378736;-20439713;9;8;352;909;1280;Perdida
Zona Bogota;Bogota Calle 153;2024;oct;278797076;102225980;176571096;149508882;27062214;9;8;416;1162;1280;Baja
Zona Bogota;Bogota Calle 153;2024;nov;248861031;98674836;150186195;174587880;-24401685;9;8;357;1079;1280;Perdida
Zona Bogota;Bogota Calle 153;2024;dic;384344093;153018206;231325887;165331193;65994694;8;8;501;1442;1280;Baja
Zona Bogota;Bogota Ciudad Salitre;2021;ene;130343363;72703546;57639817;111780967;-54141150;6;14;291;884;2120;Perdida
Zona Bogota;Bogota Ciudad Salitre;2021;feb;215744083;114387727;101356356;124688447;-23332091;6;14;492;1322;2120;Perdida
Zona Bogota;Bogota Ciudad Salitre;2021;mar;222445061;104383589;118061472;118994782;-933310;5;15;536;1389;2120;Perdida
Zona Bogota;Bogota Ciudad Salitre;2021;abr;131183651;88968197;42215454;230944559;-188729105;4;15;293;836;2120;Perdida
Zona Bogota;Bogota Ciudad Salitre;2021;may;152257193;90814669;61442524;102661314;-41218790;4;15;364;1055;2120;Perdida
Zona Bogota;Bogota Ciudad Salitre;2021;jun;206231268;111878333;94352935;103277532;-8924597;4;14;465;1304;1960;Perdida
Zona Bogota;Bogota Ciudad Salitre;2021;jul;255302523;124026727;131275796;114067665;17208131;4;15;548;1620;1960;Baja
Zona Bogota;Bogota Ciudad Salitre;2021;ago;239852581;123765943;116086638;110890474;5196164;4;15;511;1473;1960;Baja
Zona Bogota;Bogota Ciudad Salitre;2021;sep;249569616;125359862;124209754;115053720;9156034;4;15;535;1481;2120;Baja
Zona Bogota;Bogota Ciudad Salitre;2021;oct;239514861;124062248;115452613;118235890;-2783277;4;15;545;1323;2120;Perdida
Zona Bogota;Bogota Ciudad Salitre;2021;nov;272643366;129341470;143301896;101924468;41377428;4;15;489;1486;2120;Baja
Zona Bogota;Bogota Ciudad Salitre;2021;dic;318455817;156962768;161493049;123257210;38235839;4;15;640;1810;2120;Baja
Zona Bogota;Bogota Ciudad Salitre;2022;ene;206276850;105307681;100969169;115295858;-14326689;5;15;425;1204;2120;Perdida
Zona Bogota;Bogota Ciudad Salitre;2022;feb;186073141;106806105;79267036;137735188;-58468152;6;13;412;1078;1760;Perdida
Zona Bogota;Bogota Ciudad Salitre;2022;mar;239960781;114971893;124988888;115472638;9516250;6;13;460;1256;1760;Baja
Zona Bogota;Bogota Ciudad Salitre;2022;abr;262602647;125554059;137048588;119155972;17892616;8;13;491;1356;1960;Baja
Zona Bogota;Bogota Ciudad Salitre;2022;may;274508593;122946582;151562011;134660813;16901198;8;13;454;1355;1960;Baja
Zona Bogota;Bogota Ciudad Salitre;2022;jun;242577251;134733148;107844103;127036628;-19192525;8;13;450;1266;1960;Perdida
Zona Bogota;Bogota Ciudad Salitre;2022;jul;278263640;134471457;143792183;141542508;2249675;8;14;460;1426;2120;Perdida
Zona Bogota;Bogota Ciudad Salitre;2022;ago;256490504;124474770;132015734;126066874;5948860;7;14;466;1308;2120;Baja
Zona Bogota;Bogota Ciudad Salitre;2022;sep;248912717;122474244;126438473;154629817;-28191344;10;12;427;1299;1800;Perdida
Zona Bogota;Bogota Ciudad Salitre;2022;oct;251466320;106391917;145074403;167981706;-22907303;10;11;438;1225;1800;Perdida
Zona Bogota;Bogota Ciudad Salitre;2022;nov;289664916;119590908;170074008;157135632;12938376;10;11;419;1456;1800;Baja
Zona Bogota;Bogota Ciudad Salitre;2022;dic;365851866;156541376;209310490;159007888;50302602;9;12;572;1781;1800;Baja
Zona Bogota;Bogota Ciudad Salitre;2023;ene;263490877;114737066;148753811;154707072;-5953261;9;10;414;1229;1640;Perdida
Zona Bogota;Bogota Ciudad Salitre;2023;feb;215248857;102436274;112812583;112308448;504135;7;12;403;1040;1960;Perdida
Zona Bogota;Bogota Ciudad Salitre;2023;mar;251076783;115498191;135578592;127657831;7920761;8;11;451;1249;1800;Baja
Zona Bogota;Bogota Ciudad Salitre;2023;abr;225109938;111022028;114087910;112044371;2043539;8;10;356;898;1600;Perdida
Zona Bogota;Bogota Ciudad Salitre;2023;may;263019904;125466478;137553426;119798841;17754585;8;9;441;1052;1440;Baja
Zona Bogota;Bogota Ciudad Salitre;2023;jun;277537226;115364679;162172547;148457149;13715398;8;9;438;1090;1440;Baja
Zona Bogota;Bogota Ciudad Salitre;2023;jul;236977164;139328417;97648747;143311880;-45663133;10;11;423;1028;1600;Perdida
Zona Bogota;Bogota Ciudad Salitre;2023;ago;304589979;139521920;165068059;160134800;4933259;10;11;456;1250;1600;Baja
Zona Bogota;Bogota Ciudad Salitre;2023;sep;233022092;105383125;127638967;159829609;-32190642;10;11;352;943;1600;Perdida
Zona Bogota;Bogota Ciudad Salitre;2023;oct;262274216;130094098;132180118;174574715;-42394597;10;11;400;1160;1600;Perdida
Zona Bogota;Bogota Ciudad Salitre;2023;nov;277880225;125427022;152453203;195910711;-43457508;10;11;402;1213;1600;Perdida
Zona Bogota;Bogota Ciudad Salitre;2023;dic;380728921;198450135;182278786;179905306;2373480;10;10;516;1440;1440;Perdida
Zona Bogota;Bogota Ciudad Salitre;2024;ene;271123241;130666057;140457184;187150287;-46693103;10;10;385;1034;1440;Perdida
Zona Bogota;Bogota Ciudad Salitre;2024;feb;276069685;133843069;142226616;198342725;-56116109;11;12;358;1159;1760;Perdida
Zona Bogota;Bogota Ciudad Salitre;2024;mar;258715513;139901931;118813582;192722246;-73908664;11;11;380;1022;1600;Perdida
Zona Bogota;Bogota Ciudad Salitre;2024;abr;292126383;153514261;138612122;195542209;-56930087;12;8;369;1033;1120;Perdida
Zona Bogota;Bogota Ciudad Salitre;2024;may;270173077;116853635;153319442;167179501;-13860059;12;8;366;1016;1120;Perdida
Zona Bogota;Bogota Ciudad Salitre;2024;jun;305599172;125913906;179685266;198111711;-18426445;13;7;398;1076;1280;Perdida
Zona Bogota;Bogota Ciudad Salitre;2024;jul;267531382;118660638;148870744;170114910;-21244166;12;7;361;989;1280;Perdida
Zona Bogota;Bogota Ciudad Salitre;2024;ago;267556914;122868512;144688402;193647748;-48959346;11;8;396;1119;1280;Perdida
Zona Bogota;Bogota Ciudad Salitre;2024;sep;265073043;122968401;142104642;186490091;-44385449;11;9;354;1026;1440;Perdida
Zona Bogota;Bogota Ciudad Salitre;2024;oct;331171003;137287484;193883519;168768741;25114778;8;9;418;1276;1440;Baja
Zona Bogota;Bogota Ciudad Salitre;2024;nov;264715383;111328996;153386387;185309093;-31922706;7;10;348;1016;1440;Perdida
Zona Bogota;Bogota Ciudad Salitre;2024;dic;356815613;141340847;215474766;241695633;-26220867;7;10;468;1418;1440;Perdida
Zona Bogota;Bogota Colision;2021;ene;465897852;260854455;205043397;196219310;8824087;22;45;151;4988;6760;Baja
Zona Bogota;Bogota Colision;2021;feb;559064006;279913618;279150388;214901715;64248673;19;46;208;5855;6920;Baja
Zona Bogota;Bogota Colision;2021;mar;600701069;334635472;266065597;214737574;51328023;22;46;232;6353;6560;Baja
Zona Bogota;Bogota Colision;2021;abr;478688061;297863170;180824891;217077707;-36252816;24;43;222;5426;6560;Perdida
Zona Bogota;Bogota Colision;2021;may;513672671;335274467;178398204;239955882;-61557678;24;43;188;5539;6560;Perdida
Zona Bogota;Bogota Colision;2021;jun;488110994;327419958;160691036;183799522;-23108486;24;43;198;5383;6560;Perdida
Zona Bogota;Bogota Colision;2021;jul;543264959;353839479;189425480;204416550;-14991070;26;45;209;5817;6400;Perdida
Zona Bogota;Bogota Colision;2021;ago;613912657;364875683;249036974;195963391;53073583;27;47;214;6691;6760;Baja
Zona Bogota;Bogota Colision;2021;sep;883813948;432057856;451756092;226508949;225247143;27;48;284;9072;6920;Media
Zona Bogota;Bogota Colision;2021;oct;865859823;506521886;359337937;272210951;87126986;26;47;278;8889;6720;Baja
Zona Bogota;Bogota Colision;2021;nov;871160893;446714234;424446659;210946080;213500579;25;47;277;9140;6720;Media
Zona Bogota;Bogota Colision;2021;dic;701093598;425942608;275150990;192601060;82549930;25;45;296;7207;6560;Baja
Zona Bogota;Bogota Colision;2022;ene;830962691;384355191;446607500;246447783;200159717;25;46;300;8858;6720;Media
Zona Bogota;Bogota Colision;2022;feb;880326989;438592275;441734714;258195815;183538899;25;45;278;9061;6560;Baja
Zona Bogota;Bogota Colision;2022;mar;704572292;458746794;245825498;239102510;6722988;24;46;217;7415;6520;Perdida
Zona Bogota;Bogota Colision;2022;abr;659509496;377391870;282117626;226555561;55562065;28;42;237;6540;6320;Baja
Zona Bogota;Bogota Colision;2022;may;651984120;364066933;287917187;233244737;54672450;29;41;245;7036;6160;Baja
Zona Bogota;Bogota Colision;2022;jun;703334519;377998227;325336292;217393584;107942708;29;41;248;7081;6160;Baja
Zona Bogota;Bogota Colision;2022;jul;722952170;381529837;341422333;229605713;111816620;28;41;275;6662;6160;Baja
Zona Bogota;Bogota Colision;2022;ago;770205627;374500373;395705254;228474743;167230511;28;41;258;7260;6160;Baja
Zona Bogota;Bogota Colision;2022;sep;681130857;383382580;297748277;200722338;97025939;23;42;221;6530;6720;Baja
Zona Bogota;Bogota Colision;2022;oct;578241370;334163022;244078348;190654327;53424021;22;42;201;5755;7120;Baja
Zona Bogota;Bogota Colision;2022;nov;649189509;334775604;314413905;201793527;112620378;22;43;226;6089;7440;Baja
Zona Bogota;Bogota Colision;2022;dic;483999497;302945113;181054384;197082139;-16027755;21;37;230;4268;5920;Perdida
Zona Bogota;Bogota Colision;2023;ene;809598135;383512440;426085695;248408141;177677554;22;34;194;7996;5960;Baja
Zona Bogota;Bogota Colision;2023;feb;755885998;301899902;453986096;249345847;204640249;22;35;229;7512;6120;Media
Zona Bogota;Bogota Colision;2023;mar;759298117;359371162;399926955;277753244;122173711;23;33;250;6704;5880;Baja
Zona Bogota;Bogota Colision;2023;abr;635579848;318687299;316892549;191496307;125396242;23;34;191;5411;5880;Baja
Zona Bogota;Bogota Colision;2023;may;744384191;352228816;392155375;178101152;214054223;23;34;217;6553;5480;Media
Zona Bogota;Bogota Colision;2023;jun;725728900;383517433;342211467;230495784;111715683;23;36;249;5897;5480;Baja
Zona Bogota;Bogota Colision;2023;jul;749930806;395902685;354028121;204769597;149258524;24;36;223;6701;5480;Baja
Zona Bogota;Bogota Colision;2023;ago;838265514;433473935;404791579;212637210;192154369;23;38;262;7017;5640;Media
Zona Bogota;Bogota Colision;2023;sep;645570661;333791111;311779550;175454800;136324750;21;36;215;5601;5320;Baja
Zona Bogota;Bogota Colision;2023;oct;806808921;409438579;397370342;204597046;192773296;19;36;243;6778;5480;Media
Zona Bogota;Bogota Colision;2023;nov;810765261;446224101;364541160;200326962;164214198;18;38;307;6688;5640;Baja
Zona Bogota;Bogota Colision;2023;dic;630603533;345381681;285221852;174876455;110345397;17;34;237;4208;5160;Baja
Zona Bogota;Bogota Colision;2024;ene;773931231;465762027;308169204;252454226;55714978;17;34;216;7321;5160;Baja
Zona Bogota;Bogota Colision;2024;feb;875704531;388997010;486707521;131860184;354847337;20;35;235;8021;5400;Media
Zona Bogota;Bogota Colision;2024;mar;665529033;341143399;324385634;252489377;71896257;20;35;192;5904;5400;Baja
Zona Bogota;Bogota Colision;2024;abr;602397072;334767029;267630043;146535754;121094289;20;37;147;5319;5720;Baja
Zona Bogota;Bogota Colision;2024;may;569745816;314930363;254815453;235232253;19583200;20;37;196;4525;6040;Baja
Zona Bogota;Bogota Colision;2024;jun;536453498;353288701;183164797;148865545;34299252;21;41;152;4123;6800;Baja
Zona Bogota;Bogota Colision;2024;jul;654615805;365629084;288986721;246562315;42424406;20;40;214;5214;6640;Baja
Zona Bogota;Bogota Colision;2024;ago;612404273;362485942;249918331;220529032;29389299;20;42;197;5292;6800;Baja
Zona Bogota;Bogota Colision;2024;sep;559643672;389496369;170147303;192817853;-22670550;21;41;161;4640;6520;Perdida
Zona Bogota;Bogota Colision;2024;oct;686870013;324871557;361998456;184135926;177862530;22;38;178;5670;6160;Media
Zona Bogota;Bogota Colision;2024;nov;806399101;442517763;363881338;180177413;183703925;22;39;219;5724;6160;Media
Zona Bogota;Bogota Colision;2024;dic;529313399;427747556;101565843;384602672;-283036829;24;42;183;3678;6640;Perdida
Zona Bogota;Bogota Morato;2021;ene;341554690;198467884;143086806;144841559;-1754753;22;30;559;1883;4740;Perdida
Zona Bogota;Bogota Morato;2021;feb;521560025;248318836;273241189;202296634;70944555;22;29;1018;2860;4580;Baja
Zona Bogota;Bogota Morato;2021;mar;577331375;289858304;287473071;232979156;54493915;22;29;1158;3031;4740;Baja
Zona Bogota;Bogota Morato;2021;abr;420104120;239811523;180292597;159467384;20825213;22;28;700;2279;4540;Baja
Zona Bogota;Bogota Morato;2021;may;463790188;232348758;231441430;186990142;44451288;22;26;855;2582;4290;Baja
Zona Bogota;Bogota Morato;2021;jun;547454865;279594832;267860033;189995159;77864874;20;27;979;2948;4450;Baja
Zona Bogota;Bogota Morato;2021;jul;630881524;298248557;332632967;181774185;150858782;20;28;1069;3332;4290;Media
Zona Bogota;Bogota Morato;2021;ago;584900991;297833277;287067714;192371670;94696044;19;31;1067;3171;4610;Baja
Zona Bogota;Bogota Morato;2021;sep;678751938;318654259;360097679;232205063;127892616;20;31;1142;3794;4610;Baja
Zona Bogota;Bogota Morato;2021;oct;669500374;317060241;352440133;266616822;85823311;22;32;1162;3640;4770;Baja
Zona Bogota;Bogota Morato;2021;nov;657016733;309258288;347758445;232686304;115072141;22;31;1190;3632;4770;Baja
Zona Bogota;Bogota Morato;2021;dic;824815840;388057336;436758504;270136300;166622204;22;31;1381;4272;4770;Baja
Zona Bogota;Bogota Morato;2022;ene;596555229;283809640;312745589;212761664;99983925;21;31;1063;3193;4930;Baja
Zona Bogota;Bogota Morato;2022;feb;649206849;331219903;317986946;223253072;94733874;21;31;1075;3575;4930;Baja
Zona Bogota;Bogota Morato;2022;mar;692082895;336194884;355888011;231633350;124254661;22;31;1156;3673;4970;Baja
Zona Bogota;Bogota Morato;2022;abr;711318785;337334082;373984703;215172815;158811888;21;30;1113;3690;4810;Media
Zona Bogota;Bogota Morato;2022;may;718950232;355788150;363162082;227696194;135465888;21;28;1058;3577;4490;Baja
Zona Bogota;Bogota Morato;2022;jun;674288063;358586085;315701978;261223925;54478053;21;29;987;3336;4490;Baja
Zona Bogota;Bogota Morato;2022;jul;725665863;396291437;329374426;280188298;49186128;21;34;1188;3461;5330;Baja
Zona Bogota;Bogota Morato;2022;ago;714905276;361556921;353348355;226955278;126393077;21;34;1067;3474;5330;Baja
Zona Bogota;Bogota Morato;2022;sep;710517908;354639472;355878436;241227933;114650503;20;32;990;3685;5010;Baja
Zona Bogota;Bogota Morato;2022;oct;618066571;324078187;293988384;216770302;77218082;20;32;913;3035;5170;Baja
Zona Bogota;Bogota Morato;2022;nov;672212665;337071771;335140894;229514930;105625964;24;31;982;3303;5170;Baja
Zona Bogota;Bogota Morato;2022;dic;833295090;455527828;377767262;297518355;80248907;23;34;1316;4002;5330;Baja
Zona Bogota;Bogota Morato;2023;ene;674284874;340477503;333807371;262759367;71048004;24;35;965;3353;5490;Baja
Zona Bogota;Bogota Morato;2023;feb;715808010;373073416;342734594;237049433;105685161;23;37;911;3349;5850;Baja
Zona Bogota;Bogota Morato;2023;mar;815733977;457447317;358286660;196951178;161335482;22;36;973;3570;5690;Baja
Zona Bogota;Bogota Morato;2023;abr;709015076;328185956;380829120;268074491;112754629;21;36;876;3156;5690;Baja
Zona Bogota;Bogota Morato;2023;may;745172116;431852245;313319871;244809466;68510405;23;36;918;3255;5690;Baja
Zona Bogota;Bogota Morato;2023;jun;729567760;396658914;332908846;266905786;66003060;24;35;972;3307;5690;Baja
Zona Bogota;Bogota Morato;2023;jul;710964024;373419660;337544364;248313619;89230745;25;35;931;3265;5850;Baja
Zona Bogota;Bogota Morato;2023;ago;770373660;411208332;359165328;257188378;101976950;25;35;926;3302;5850;Baja
Zona Bogota;Bogota Morato;2023;sep;698660487;342315125;356345362;198278450;158066912;24;34;886;3268;5690;Media
Zona Bogota;Bogota Morato;2023;oct;665272171;374731441;290540730;289307206;1233524;24;32;801;2813;5370;Perdida
Zona Bogota;Bogota Morato;2023;nov;651871498;347939451;303932047;347994167;-44062120;23;32;862;2769;5370;Perdida
Zona Bogota;Bogota Morato;2023;dic;812228062;375588192;436639870;266696054;169943816;22;31;1025;2985;5210;Baja
Zona Bogota;Bogota Morato;2024;ene;673418815;315607390;357811425;264782203;93029222;22;32;847;2549;5370;Baja
Zona Bogota;Bogota Morato;2024;feb;637666471;292485972;345180499;246928301;98252198;21;23;793;2518;3770;Baja
Zona Bogota;Bogota Morato;2024;mar;637137099;319820762;317316337;219781445;97534892;22;23;785;2445;3770;Baja
Zona Bogota;Bogota Morato;2024;abr;661344584;293595373;367749211;285810031;81939180;22;22;830;2501;3610;Baja
Zona Bogota;Bogota Morato;2024;may;742888533;361743421;381145112;240861963;140283149;21;23;833;2904;3770;Baja
Zona Bogota;Bogota Morato;2024;jun;626047930;296314482;329733448;254029813;75703635;21;23;794;2364;3770;Baja
Zona Bogota;Bogota Morato;2024;jul;606307051;300864267;305442784;254044309;51398475;20;23;767;2324;3770;Baja
Zona Bogota;Bogota Morato;2024;ago;629574622;318852935;310721687;277103975;33617712;19;23;742;2395;3770;Baja
Zona Bogota;Bogota Morato;2024;sep;659701403;295662760;364038643;220615322;143423321;18;20;756;2674;3040;Baja
Zona Bogota;Bogota Morato;2024;oct;713185812;281582274;431603538;207016272;224587266;17;20;816;2918;3040;Media
Zona Bogota;Bogota Morato;2024;nov;635519167;261537586;373981581;228592563;145389018;18;22;806;2619;3200;Media
Zona Bogota;Bogota Morato;2024;dic;881652420;369666572;511985848;244643867;267341981;18;22;1016;3387;3200;Media
Zona Bogota;Bogota Motor Show;2021;ene;172538721;78595255;93943466;105395968;-11452502;11;12;331;960;1600;Perdida
Zona Bogota;Bogota Motor Show;2021;feb;303628385;121767948;181860437;116462964;65397473;10;11;625;1578;1600;Baja
Zona Bogota;Bogota Motor Show;2021;mar;379805491;136789514;243015977;116284315;126731662;10;9;760;2002;1440;Media
Zona Bogota;Bogota Motor Show;2021;abr;208658665;82802032;125856633;122035715;3820918;10;9;416;1161;1440;Baja
Zona Bogota;Bogota Motor Show;2021;may;252661378;113448196;139213182;112932000;26281182;10;9;505;1370;1440;Baja
Zona Bogota;Bogota Motor Show;2021;jun;305615792;121056207;184559585;123655750;60903835;11;9;602;1661;1440;Baja
Zona Bogota;Bogota Motor Show;2021;jul;339808989;111796986;228012003;124448126;103563877;11;10;698;1834;1440;Media
Zona Bogota;Bogota Motor Show;2021;ago;338816418;143141521;195674897;122656332;73018565;11;10;669;1842;1440;Baja
Zona Bogota;Bogota Motor Show;2021;sep;359861863;137582086;222279777;124294275;97985502;10;10;714;1885;1440;Media
Zona Bogota;Bogota Motor Show;2021;oct;354221417;127163049;227058368;127480619;99577749;10;10;711;1849;1440;Media
Zona Bogota;Bogota Motor Show;2021;nov;353731135;135929940;217801195;130357602;87443593;9;11;701;1800;1600;Media
Zona Bogota;Bogota Motor Show;2021;dic;451509969;156697662;294812307;148374980;146437327;9;11;861;2347;1600;Media
Zona Bogota;Bogota Motor Show;2022;ene;383381909;148952560;234429349;115000988;119428361;10;11;664;1970;1600;Media
Zona Bogota;Bogota Motor Show;2022;feb;308036153;128115339;179920814;120824423;59096391;10;11;623;1549;1600;Baja
Zona Bogota;Bogota Motor Show;2022;mar;387897510;151610312;236287198;145583664;90703534;10;11;690;1941;1600;Media
Zona Bogota;Bogota Motor Show;2022;abr;346569068;145854323;200714745;137791874;62922871;10;11;679;1633;1600;Baja
Zona Bogota;Bogota Motor Show;2022;may;367735784;144837674;222898110;133217870;89680240;10;10;601;1760;1600;Media
Zona Bogota;Bogota Motor Show;2022;jun;363320775;147605515;215715260;134141843;81573417;10;10;597;1695;1600;Media
Zona Bogota;Bogota Motor Show;2022;jul;452579491;175368402;277211089;132146547;145064542;10;10;715;2002;1600;Media
Zona Bogota;Bogota Motor Show;2022;ago;407346082;145662035;261684047;118767902;142916145;10;10;695;1957;1600;Media
Zona Bogota;Bogota Motor Show;2022;sep;401275298;155136443;246138855;131527126;114611729;10;10;653;1879;1600;Media
Zona Bogota;Bogota Motor Show;2022;oct;392387281;152601377;239785904;131708997;108076907;10;10;629;1745;1600;Media
Zona Bogota;Bogota Motor Show;2022;nov;386934638;151840570;235094068;139190973;95903095;10;10;670;1795;1600;Media
Zona Bogota;Bogota Motor Show;2022;dic;501182300;188957646;312224654;180303213;131921441;10;11;797;2335;1600;Media
Zona Bogota;Bogota Motor Show;2023;ene;420017235;167641712;252375523;131792740;120582783;11;10;651;1810;1600;Media
Zona Bogota;Bogota Motor Show;2023;feb;392503742;150701431;241802311;127000949;114801362;11;10;577;1620;1600;Media
Zona Bogota;Bogota Motor Show;2023;mar;454329477;183466411;270863066;142736809;128126257;11;9;659;1901;1440;Media
Zona Bogota;Bogota Motor Show;2023;abr;359749423;142202573;217546850;146935473;70611377;11;8;506;1479;1280;Baja
Zona Bogota;Bogota Motor Show;2023;may;396309954;175907858;220402096;139982299;80419797;11;8;597;1577;1280;Baja
Zona Bogota;Bogota Motor Show;2023;jun;412408359;172173544;240234815;135362436;104872379;11;9;625;1612;1440;Media
Zona Bogota;Bogota Motor Show;2023;jul;429163397;152292612;276870785;156055915;120814870;10;9;611;1804;1440;Media
Zona Bogota;Bogota Motor Show;2023;ago;449909968;196137145;253772823;139761922;114010901;11;9;652;1703;1440;Media
Zona Bogota;Bogota Motor Show;2023;sep;429247138;168334945;260912193;115624547;145287646;11;9;624;1587;1440;Media
Zona Bogota;Bogota Motor Show;2023;oct;377814830;169299857;208514973;159159554;49355419;11;10;572;1425;1600;Baja
Zona Bogota;Bogota Motor Show;2023;nov;423977694;191578233;232399461;164450961;67948500;10;10;633;1580;1600;Baja
Zona Bogota;Bogota Motor Show;2023;dic;542632813;217223249;325409564;174204796;151204768;10;10;701;1804;1600;Media
Zona Bogota;Bogota Motor Show;2024;ene;446772372;174513870;272258502;153165023;119093479;10;10;617;1632;1600;Media
Zona Bogota;Bogota Motor Show;2024;feb;412806588;174069696;238736892;157228498;81508394;9;10;583;1423;1600;Baja
Zona Bogota;Bogota Motor Show;2024;mar;391452988;189955035;201497953;125275296;76222657;9;10;548;1428;1600;Baja
Zona Bogota;Bogota Motor Show;2024;abr;457240888;192732285;264508603;130746804;133761799;10;11;572;1468;1760;Media
Zona Bogota;Bogota Motor Show;2024;may;463482715;233064530;230418185;156630779;73787406;11;10;552;1521;1600;Baja
Zona Bogota;Bogota Motor Show;2024;jun;403935253;188598958;215336295;151691860;63644435;11;10;528;1325;1600;Baja
Zona Bogota;Bogota Motor Show;2024;jul;448647174;178970791;269676383;165474977;104201406;10;10;620;1484;1600;Media
Zona Bogota;Bogota Motor Show;2024;ago;479882244;196048242;283834002;166907849;116926153;10;10;605;1561;1600;Media
Zona Bogota;Bogota Motor Show;2024;sep;470781883;210059456;260722427;157638686;103083741;10;13;602;1462;2080;Baja
Zona Bogota;Bogota Motor Show;2024;oct;491147423;249970640;241176783;162649165;78527618;10;12;651;1590;1920;Baja
Zona Bogota;Bogota Motor Show;2024;nov;502890340;206297570;296592770;172556575;124036195;10;12;600;1731;1920;Media
Zona Bogota;Bogota Motor Show;2024;dic;625300750;251622767;373677983;182639237;191038746;10;12;726;1947;1920;Media
Zona Bogota;Bogota Toberin;2021;ene;4415873;16212190;-11796317;36244980;-48041297;2;4;21;23;460;Perdida
Zona Bogota;Bogota Toberin;2021;feb;35391792;25950957;9440835;38932589;-29491754;2;4;123;186;460;Perdida
Zona Bogota;Bogota Toberin;2021;mar;39498884;23514591;15984293;39617812;-23633519;2;3;130;230;460;Perdida
Zona Bogota;Bogota Toberin;2021;abr;27091995;22635120;4456875;39616978;-35160103;2;3;86;154;460;Perdida
Zona Bogota;Bogota Toberin;2021;may;34537887;22854877;11683010;38940439;-27257429;1;3;107;198;460;Perdida
Zona Bogota;Bogota Toberin;2021;jun;43837929;25845980;17991949;36248989;-18257040;1;3;128;261;460;Perdida
Zona Bogota;Bogota Toberin;2021;jul;40732832;25728187;15004645;37018438;-22013793;1;3;121;235;460;Perdida
Zona Bogota;Bogota Toberin;2021;ago;52152263;28611451;23540812;37109154;-13568342;2;3;149;300;460;Perdida
Zona Bogota;Bogota Toberin;2021;sep;47782610;26960703;20821907;38511963;-17690056;2;3;136;271;460;Perdida
Zona Bogota;Bogota Toberin;2021;oct;45415204;36718289;8696915;38367099;-29670184;2;3;138;247;460;Perdida
Zona Bogota;Bogota Toberin;2021;nov;49100337;37408182;11692155;41095962;-29403807;2;3;143;271;460;Perdida
Zona Bogota;Bogota Toberin;2021;dic;62165498;37323426;24842072;41910388;-17068316;2;3;189;345;460;Perdida
Zona Bogota;Bogota Toberin;2022;ene;51357125;32768300;18588825;38416245;-19827420;2;3;144;313;460;Perdida
Zona Bogota;Bogota Toberin;2022;feb;42231320;31121295;11110025;35385578;-24275553;2;3;125;256;460;Perdida
Zona Bogota;Bogota Toberin;2022;mar;45635270;32864840;12770430;36002956;-23232526;2;3;131;254;460;Perdida
Zona Bogota;Bogota Toberin;2022;abr;52437785;37102310;15335475;40972247;-25636772;2;3;142;282;460;Perdida
Zona Bogota;Bogota Toberin;2022;may;62045408;38147621;23897787;39324324;-15426537;2;3;159;335;460;Perdida
Zona Bogota;Bogota Toberin;2022;jun;55447131;39566370;15880761;40619739;-24738978;2;3;137;269;460;Perdida
Zona Bogota;Bogota Toberin;2022;jul;51525328;37873877;13651451;37356294;-23704843;2;3;130;255;460;Perdida
Zona Bogota;Bogota Toberin;2022;ago;63394144;30854675;32539469;39036396;-6496927;2;3;147;343;460;Perdida
Zona Bogota;Bogota Toberin;2022;sep;40641032;32856591;7784441;45483792;-37699351;3;2;118;204;320;Perdida
Zona Bogota;Bogota Toberin;2022;oct;57340681;20835517;36505164;48577665;-12072501;3;2;145;279;320;Perdida
Zona Bogota;Bogota Toberin;2022;nov;50681981;27072571;23609410;60476463;-36867053;3;2;137;273;320;Perdida
Zona Bogota;Bogota Toberin;2022;dic;75071898;34824361;40247537;43252915;-3005378;3;2;218;415;320;Perdida
Zona Bogota;Bogota Toberin;2023;ene;54845029;32381309;22463720;46212511;-23748791;3;2;139;268;320;Perdida
Zona Bogota;Bogota Toberin;2023;feb;56082074;17062826;39019248;51272424;-12253176;3;2;134;297;320;Perdida
Zona Bogota;Bogota Toberin;2023;mar;59076674;36434812;22641862;57246237;-34604375;3;2;158;282;320;Perdida
Zona Bogota;Bogota Toberin;2023;abr;55243410;33631756;21611654;42485276;-20873622;3;2;146;254;320;Perdida
Zona Bogota;Bogota Toberin;2023;may;64289524;33513486;30776038;51883880;-21107842;3;2;149;313;320;Perdida
Zona Bogota;Bogota Toberin;2023;jun;58557811;29860963;28696848;51426134;-22729286;3;2;151;289;320;Perdida
Zona Bogota;Bogota Toberin;2023;jul;65321325;37400288;27921037;66391151;-38470114;3;2;151;311;320;Perdida
Zona Bogota;Bogota Toberin;2023;ago;57644828;30868577;26776251;61063690;-34287439;3;2;149;297;320;Perdida
Zona Bogota;Bogota Toberin;2023;sep;57785564;34690352;23095212;59892883;-36797671;3;2;134;312;320;Perdida
Zona Bogota;Bogota Toberin;2023;oct;105802416;52158518;53643898;77264479;-23620581;3;2;195;609;320;Perdida
Zona Bogota;Bogota Toberin;2023;nov;108986697;38000017;70986680;56432800;14553880;3;2;165;656;320;Baja
Zona Bogota;Bogota Toberin;2023;dic;96892670;42745879;54146791;59355799;-5209008;3;2;194;524;320;Perdida
Zona Bogota;Bogota Toberin;2024;ene;147029064;105463809;41565255;73919927;-32354672;4;3;173;884;640;Perdida
Zona Bogota;Bogota Toberin;2024;feb;140814876;118485909;22328967;70056664;-47727697;4;10;158;917;1880;Perdida
Zona Bogota;Bogota Toberin;2024;mar;136226477;92691083;43535394;79403475;-35868081;4;10;167;750;1880;Perdida
Zona Bogota;Bogota Toberin;2024;abr;113259882;118890197;-5630315;76087575;-81717890;4;11;146;599;2040;Perdida
Zona Bogota;Bogota Toberin;2024;may;130817593;107694178;23123415;92088356;-68964941;5;11;157;766;2040;Perdida
Zona Bogota;Bogota Toberin;2024;jun;167683604;132584029;35099575;86015948;-50916373;4;10;187;1072;1720;Perdida
Zona Bogota;Bogota Toberin;2024;jul;236186028;140298104;95887924;88711292;7176632;4;9;204;1370;1560;Baja
Zona Bogota;Bogota Toberin;2024;ago;143870740;102738617;41132123;70950623;-29818500;4;9;161;817;1560;Perdida
Zona Bogota;Bogota Toberin;2024;sep;164258632;107543441;56715191;91883143;-35167952;3;8;152;1118;1400;Perdida
Zona Bogota;Bogota Toberin;2024;oct;151241389;86236140;65005249;76649802;-11644553;3;8;169;963;1400;Perdida
Zona Bogota;Bogota Toberin;2024;nov;99109690;103429404;-4319714;77848505;-82168219;3;8;128;572;1400;Perdida
Zona Bogota;Bogota Toberin;2024;dic;121920406;111379399;10541007;79137514;-68596507;2;8;172;703;1400;Perdida
Zona Bogota;Chia;2021;ene;220824366;96034424;124789942;55578560;69211382;5;12;498;1260;1600;Media
Zona Bogota;Chia;2021;feb;218518039;94589765;123928274;60671096;63257178;5;12;507;1239;1440;Media
Zona Bogota;Chia;2021;mar;276808536;107920895;168887641;67136427;101751214;5;11;647;1522;1280;Media
Zona Bogota;Chia;2021;abr;213186688;89581839;123604849;60798085;62806764;5;11;500;1187;1280;Media
Zona Bogota;Chia;2021;may;164406473;80467178;83939295;57679688;26259607;5;11;404;935;1280;Baja
Zona Bogota;Chia;2021;jun;245205671;99095824;146109847;67940475;78169372;5;11;571;1366;1280;Media
Zona Bogota;Chia;2021;jul;258468848;109602952;148865896;71601698;77264198;5;11;566;1350;1120;Media
Zona Bogota;Chia;2021;ago;257271741;94758306;162513435;56334002;106179433;4;11;603;1359;1120;Media
Zona Bogota;Chia;2021;sep;282050648;119264358;162786290;66063356;96722934;4;10;634;1508;1120;Media
Zona Bogota;Chia;2021;oct;285808060;111392015;174416045;78277135;96138910;4;11;658;1461;1280;Media
Zona Bogota;Chia;2021;nov;292653686;107722154;184931532;80224918;104706614;5;11;647;1499;1280;Media
Zona Bogota;Chia;2021;dic;346394578;125578330;220816248;80952222;139864026;6;12;796;1793;1440;Media
Zona Bogota;Chia;2022;ene;282980547;106111212;176869335;78414866;98454469;6;13;626;1564;1600;Media
Zona Bogota;Chia;2022;feb;292879809;119110575;173769234;81123316;92645918;6;12;615;1574;1600;Media
Zona Bogota;Chia;2022;mar;339978711;130089959;209888752;85863651;124025101;6;11;713;1841;1440;Media
Zona Bogota;Chia;2022;abr;301507509;120539565;180967944;85467842;95500102;7;10;611;1528;1440;Media
Zona Bogota;Chia;2022;may;333992421;123594758;210397663;79369858;131027805;5;10;664;1670;1440;Media
Zona Bogota;Chia;2022;jun;307511810;114722042;192789768;63592654;129197114;5;10;617;1598;1440;Media
Zona Bogota;Chia;2022;jul;320904901;122916685;197988216;54529398;143458818;4;11;661;1573;1600;Alta
Zona Bogota;Chia;2022;ago;363990251;137427117;226563134;71300197;155262937;5;11;700;1745;1600;Media
Zona Bogota;Chia;2022;sep;343790056;144744111;199045945;88604249;110441696;7;12;646;1641;1760;Media
Zona Bogota;Chia;2022;oct;346944868;140800738;206144130;85712485;120431645;7;12;649;1587;1760;Media
Zona Bogota;Chia;2022;nov;327258266;135634435;191623831;110978683;80645148;8;11;626;1564;1760;Media
Zona Bogota;Chia;2022;dic;392703227;154183435;238519792;120248925;118270867;6;12;704;1826;1760;Media
Zona Bogota;Chia;2023;ene;349624210;143740642;205883568;82792870;123090698;6;12;628;1479;1920;Media
Zona Bogota;Chia;2023;feb;320978516;120921293;200057223;86325022;113732201;6;10;547;1362;1600;Media
Zona Bogota;Chia;2023;mar;411004653;172717838;238286815;84734107;153552708;6;10;653;1679;1600;Media
Zona Bogota;Chia;2023;abr;375430800;140487387;234943413;75484090;159459323;6;10;613;1618;1600;Media
Zona Bogota;Chia;2023;may;368150453;157471501;210678952;89748735;120930217;7;10;612;1560;1600;Media
Zona Bogota;Chia;2023;jun;341519416;142403701;199115715;107014771;92100944;7;11;601;1416;1760;Media
Zona Bogota;Chia;2023;jul;423266202;183689517;239576685;94002650;145574035;7;11;636;1841;1760;Media
Zona Bogota;Chia;2023;ago;409326915;183212437;226114478;88055636;138058842;7;11;661;1738;1760;Media
Zona Bogota;Chia;2023;sep;372151186;159777708;212373478;74946773;137426705;7;11;629;1568;1760;Media
Zona Bogota;Chia;2023;oct;392123129;164538105;227585024;125669974;101915050;6;10;603;1570;1600;Media
Zona Bogota;Chia;2023;nov;416638601;170482005;246156596;86601519;159555077;7;8;642;1699;1280;Media
Zona Bogota;Chia;2023;dic;576265294;160063515;416201779;98055037;318146742;7;9;721;1793;1440;Alta
Zona Bogota;Chia;2024;ene;426736655;177045270;249691385;96367702;153323683;7;9;650;1662;1440;Media
Zona Bogota;Chia;2024;feb;402235831;166408688;235827143;127454021;108373122;7;9;572;1533;1440;Media
Zona Bogota;Chia;2024;mar;382354375;173926399;208427976;103306436;105121540;7;9;572;1385;1440;Media
Zona Bogota;Chia;2024;abr;394825703;163546267;231279436;118372564;112906872;8;10;563;1344;1600;Media
Zona Bogota;Chia;2024;may;435038815;178511431;256527384;163868795;92658589;8;12;608;1628;1960;Baja
Zona Bogota;Chia;2024;jun;426935314;181786915;245148399;197230851;47917548;8;12;572;1514;1960;Baja
Zona Bogota;Chia;2024;jul;419756823;185736247;234020576;156500633;77519943;8;12;575;1527;1960;Baja
Zona Bogota;Chia;2024;ago;398780296;178163542;220616754;98939338;121677416;7;10;571;1502;1640;Media
Zona Bogota;Chia;2024;sep;394842956;165685696;229157260;106430176;122727084;7;9;482;1457;1440;Media
Zona Bogota;Chia;2024;oct;405035159;173833374;231201785;113068016;118133769;8;10;604;1413;1600;Media
Zona Bogota;Chia;2024;nov;415234209;183314590;231919619;110963242;120956377;6;12;608;1484;1920;Media
Zona Bogota;Chia;2024;dic;564714630;206666320;358048310;135036990;223011320;6;11;695;1896;1760;Media
Zona Bogota;PDI  (Patio Calle 80);2021;ene;315465709;196187533;119278176;78346514;40931662;7;33;771;1905;3350;Baja
Zona Bogota;PDI  (Patio Calle 80);2021;feb;429917660;178306497;251611163;73662292;177948871;6;34;984;2584;3670;Media
Zona Bogota;PDI  (Patio Calle 80);2021;mar;610087086;317621127;292465959;86861374;205604585;6;35;1426;3335;3260;Media
Zona Bogota;PDI  (Patio Calle 80);2021;abr;479294345;231905938;247388407;79696740;167691667;6;34;1378;2856;3260;Media
Zona Bogota;PDI  (Patio Calle 80);2021;may;288355717;178504889;109850828;70437761;39413067;6;35;722;1645;3260;Baja
Zona Bogota;PDI  (Patio Calle 80);2021;jun;487645012;245687763;241957249;71655746;170301503;6;34;1161;2453;2940;Media
Zona Bogota;PDI  (Patio Calle 80);2021;jul;591125256;259369154;331756102;83210600;248545502;6;37;1511;3062;2940;Media
Zona Bogota;PDI  (Patio Calle 80);2021;ago;606801774;556258759;50543015;73560086;-23017071;6;37;1556;3377;3100;Perdida
Zona Bogota;PDI  (Patio Calle 80);2021;sep;673045589;353614701;319430888;84915141;234515747;6;37;1756;3686;3100;Media
Zona Bogota;PDI  (Patio Calle 80);2021;oct;495622305;324538410;171083895;72932879;98151016;6;35;1252;2694;2940;Baja
Zona Bogota;PDI  (Patio Calle 80);2021;nov;449227563;270364528;178863035;73067358;105795677;6;35;1115;2559;2620;Media
Zona Bogota;PDI  (Patio Calle 80);2021;dic;450961657;287801228;163160429;72241222;90919207;6;36;1082;2655;2780;Baja
Zona Bogota;PDI  (Patio Calle 80);2022;ene;223231318;218641119;4590199;71985194;-67394995;5;35;579;1431;2780;Perdida
Zona Bogota;PDI  (Patio Calle 80);2022;feb;369282006;263409015;105872991;80136589;25736402;5;35;785;2258;2940;Baja
Zona Bogota;PDI  (Patio Calle 80);2022;mar;279469736;241489808;37979928;77828855;-39848927;5;32;681;1791;2780;Perdida
Zona Bogota;PDI  (Patio Calle 80);2022;abr;283372249;177533323;105838926;71648386;34190540;5;32;575;1567;2780;Baja
Zona Bogota;PDI  (Patio Calle 80);2022;may;317347867;227905221;89442646;81047673;8394973;5;31;676;1723;2780;Baja
Zona Bogota;PDI  (Patio Calle 80);2022;jun;314827346;264789517;50037829;74450710;-24412881;5;33;652;1700;2940;Perdida
Zona Bogota;PDI  (Patio Calle 80);2022;jul;303542022;313298539;-9756517;79880891;-89637408;5;31;692;1690;2940;Perdida
Zona Bogota;PDI  (Patio Calle 80);2022;ago;385908988;287161813;98747175;80217717;18529458;5;31;815;2232;2940;Baja
Zona Bogota;PDI  (Patio Calle 80);2022;sep;232449306;267709413;-35260107;64092221;-99352328;5;31;561;1339;2780;Perdida
Zona Bogota;PDI  (Patio Calle 80);2022;oct;167803918;240708406;-72904488;75202318;-148106806;5;29;417;949;2780;Perdida
Zona Bogota;PDI  (Patio Calle 80);2022;nov;174483434;230644405;-56160971;65677984;-121838955;5;30;371;943;4860;Perdida
Zona Bogota;PDI  (Patio Calle 80);2022;dic;217156499;272677748;-55521249;61815562;-117336811;5;29;437;1186;2940;Perdida
Zona Bogota;PDI  (Patio Calle 80);2023;ene;182900724;254505994;-71605270;111403230;-183008500;5;29;380;838;2940;Perdida
Zona Bogota;PDI  (Patio Calle 80);2023;feb;276295815;266367700;9928115;106564184;-96636069;5;26;535;1282;2420;Perdida
Zona Bogota;PDI  (Patio Calle 80);2023;mar;328157711;321683858;6473853;66104634;-59630781;5;25;648;1574;2420;Perdida
Zona Bogota;PDI  (Patio Calle 80);2023;abr;312313164;293173942;19139222;61621925;-42482703;5;25;572;1351;2420;Perdida
Zona Bogota;PDI  (Patio Calle 80);2023;may;338681738;422256408;-83574670;66688172;-150262842;5;26;600;1745;2420;Perdida
Zona Bogota;PDI  (Patio Calle 80);2023;jun;393344905;180349779;212995126;95866871;117128255;5;27;668;1969;2580;Media
Zona Bogota;PDI  (Patio Calle 80);2023;jul;381653230;175633798;206019432;46846175;159173257;7;25;643;1977;2580;Media
Zona Bogota;PDI  (Patio Calle 80);2023;ago;416758749;227037146;189721603;60767333;128954270;7;25;683;2092;2580;Media
Zona Bogota;PDI  (Patio Calle 80);2023;sep;455187410;179559075;275628335;61431130;214197205;7;23;748;2408;2420;Alta
Zona Bogota;PDI  (Patio Calle 80);2023;oct;428756456;196085162;232671294;71770231;160901063;6;25;664;2361;2580;Media
Zona Bogota;PDI  (Patio Calle 80);2023;nov;817066391;318685855;498380536;129752949;368627587;5;26;1190;4270;2740;Alta
Zona Bogota;PDI  (Patio Calle 80);2023;dic;1046722881;426748533;619974348;134739624;485234724;5;31;1275;5445;3240;Alta
Zona Bogota;PDI  (Patio Calle 80);2024;ene;453842781;284396861;169445920;104740286;64705634;5;31;565;2532;3400;Baja
Zona Bogota;PDI  (Patio Calle 80);2024;feb;577658295;268222998;309435297;79321010;230114287;5;31;825;3045;3240;Media
Zona Bogota;PDI  (Patio Calle 80);2024;mar;571230715;309044454;262186261;131428714;130757547;6;31;836;2854;3240;Media
Zona Bogota;PDI  (Patio Calle 80);2024;abr;571781649;306150953;265630696;128510716;137119980;6;32;792;2924;3240;Media
Zona Bogota;PDI  (Patio Calle 80);2024;may;579524801;297736742;281788059;177284612;104503447;7;32;699;2895;3240;Baja
Zona Bogota;PDI  (Patio Calle 80);2024;jun;512028972;207064948;304964024;121812116;183151908;7;32;636;2496;3080;Media
Zona Bogota;PDI  (Patio Calle 80);2024;jul;565388699;360653857;204734842;124432444;80302398;7;32;853;2689;3080;Baja
Zona Bogota;PDI  (Patio Calle 80);2024;ago;593335311;298731203;294604108;171173822;123430286;6;32;878;2578;3080;Baja
Zona Bogota;PDI  (Patio Calle 80);2024;sep;725315438;292915418;432400020;146949359;285450661;6;34;836;3033;3240;Media
Zona Bogota;PDI  (Patio Calle 80);2024;oct;657756090;319581132;338174958;157129326;181045632;7;40;911;3068;3560;Media
Zona Bogota;PDI  (Patio Calle 80);2024;nov;1092659504;430204403;662455101;184238617;478216484;9;40;1362;5010;4120;Alta
Zona Bogota;PDI  (Patio Calle 80);2024;dic;1254461017;478928674;775532343;202763529;572768814;9;40;1885;5343;4120;Alta
Zonas Secundarias;Barranquilla 77;2021;ene;406773234;185031502;221741732;170055794;51685938;14;31;678;3534;3430;Baja
Zonas Secundarias;Barranquilla 77;2021;feb;403859171;187191548;216667623;160292431;56375192;15;31;668;3613;3590;Baja
Zonas Secundarias;Barranquilla 77;2021;mar;444535430;214417083;230118347;190227787;39890560;15;29;721;3580;3430;Baja
Zonas Secundarias;Barranquilla 77;2021;abr;310618175;181456648;129161527;133284326;-4122799;15;30;469;3044;3590;Perdida
Zonas Secundarias;Barranquilla 77;2021;may;344420423;198100523;146319900;174538596;-28218696;14;31;528;3284;3750;Perdida
Zonas Secundarias;Barranquilla 77;2021;jun;371585387;212531708;159053679;176508895;-17455216;14;31;670;3254;3750;Perdida
Zonas Secundarias;Barranquilla 77;2021;jul;454300327;216640395;237659932;179337949;58321983;14;31;760;3606;3750;Baja
Zonas Secundarias;Barranquilla 77;2021;ago;449373683;213036058;236337625;191610697;44726928;14;33;748;3732;3750;Baja
Zonas Secundarias;Barranquilla 77;2021;sep;487590757;248212503;239378254;179846411;59531843;15;35;784;4138;4070;Baja
Zonas Secundarias;Barranquilla 77;2021;oct;483033937;239718281;243315656;179806527;63509129;15;35;781;3968;4070;Baja
Zonas Secundarias;Barranquilla 77;2021;nov;492985094;235734566;257250528;211624200;45626328;15;35;750;4390;4070;Baja
Zonas Secundarias;Barranquilla 77;2021;dic;461042306;241987212;219055094;194069215;24985879;16;35;829;3337;4070;Baja
Zonas Secundarias;Barranquilla 77;2022;ene;503276922;247953265;255323657;192509461;62814196;16;35;789;4187;4090;Baja
Zonas Secundarias;Barranquilla 77;2022;feb;531806854;279813400;251993454;239972908;12020546;16;40;806;4729;4890;Baja
Zonas Secundarias;Barranquilla 77;2022;mar;511048522;294770623;216277899;212956246;3321653;17;41;856;4290;5090;Perdida
Zonas Secundarias;Barranquilla 77;2022;abr;478909610;265767577;213142033;242879069;-29737036;19;38;748;3723;5090;Perdida
Zonas Secundarias;Barranquilla 77;2022;may;458759846;242983614;215776232;260766078;-44989846;20;37;744;3502;4930;Perdida
Zonas Secundarias;Barranquilla 77;2022;jun;518004234;276132733;241871501;214017180;27854321;20;38;742;3890;5090;Baja
Zonas Secundarias;Barranquilla 77;2022;jul;538671639;297148162;241523477;271516490;-29993013;20;38;768;3814;5250;Perdida
Zonas Secundarias;Barranquilla 77;2022;ago;526866570;319396388;207470182;228560688;-21090506;19;41;771;3902;5730;Perdida
Zonas Secundarias;Barranquilla 77;2022;sep;597978768;316871789;281106979;308749823;-27642844;20;43;749;4464;5930;Perdida
Zonas Secundarias;Barranquilla 77;2022;oct;517692322;316390233;201302089;235201254;-33899165;20;43;685;4301;5930;Perdida
Zonas Secundarias;Barranquilla 77;2022;nov;575650041;297941518;277708523;266243194;11465329;21;36;687;4211;5450;Baja
Zonas Secundarias;Barranquilla 77;2022;dic;591312071;304297825;287014246;230181830;56832416;22;39;747;4231;5290;Baja
Zonas Secundarias;Barranquilla 77;2023;ene;533170981;288365968;244805013;228290076;16514937;21;39;625;4296;5290;Baja
Zonas Secundarias;Barranquilla 77;2023;feb;547551940;276679721;270872219;216599681;54272538;23;37;580;4194;5290;Baja
Zonas Secundarias;Barranquilla 77;2023;mar;642177929;325378563;316799366;232806608;83992758;23;36;716;4652;5290;Baja
Zonas Secundarias;Barranquilla 77;2023;abr;506319663;287156220;219163443;206047088;13116355;23;37;596;3826;5130;Baja
Zonas Secundarias;Barranquilla 77;2023;may;631343944;339069596;292274348;218676079;73598269;21;37;661;3926;5130;Baja
Zonas Secundarias;Barranquilla 77;2023;jun;600634484;320997110;279637374;272908231;6729143;23;42;626;4365;5610;Baja
Zonas Secundarias;Barranquilla 77;2023;jul;459488069;274326550;185161519;169060465;16101054;23;42;759;3035;5610;Baja
Zonas Secundarias;Barranquilla 77;2023;ago;392128950;208092561;184036389;160977910;23058479;13;30;675;2133;3530;Baja
Zonas Secundarias;Barranquilla 77;2023;sep;406526492;267897111;138629381;167118563;-28489182;13;27;631;2476;3050;Perdida
Zonas Secundarias;Barranquilla 77;2023;oct;429200916;297174680;132026236;217774729;-85748493;13;27;669;2478;3050;Perdida
Zonas Secundarias;Barranquilla 77;2023;nov;410417686;268401789;142015897;204566291;-62550394;13;26;646;2313;2890;Perdida
Zonas Secundarias;Barranquilla 77;2023;dic;379620747;177257657;202363090;189727722;12635368;14;26;641;2435;3050;Baja
Zonas Secundarias;Barranquilla 77;2024;ene;358346763;228091636;130255127;172624032;-42368905;14;25;613;1914;2890;Perdida
Zonas Secundarias;Barranquilla 77;2024;feb;395029675;281068942;113960733;200660659;-86699926;16;25;568;2199;3050;Perdida
Zonas Secundarias;Barranquilla 77;2024;mar;465198263;258771264;206426999;220879237;-14452238;17;25;643;2610;3050;Perdida
Zonas Secundarias;Barranquilla 77;2024;abr;464741909;297351277;167390632;203706062;-36315430;16;25;729;2570;3210;Perdida
Zonas Secundarias;Barranquilla 77;2024;may;531450780;315437614;216013166;240320742;-24307576;14;25;715;2997;3210;Perdida
Zonas Secundarias;Barranquilla 77;2024;jun;354093266;303448275;50644991;200150599;-149505608;14;26;543;1763;3370;Perdida
Zonas Secundarias;Barranquilla 77;2024;jul;385108456;202033497;183074959;167285158;15789801;11;26;560;2198;3370;Baja
Zonas Secundarias;Barranquilla 77;2024;ago;368338879;276424628;91914251;181020940;-89106689;11;27;516;1888;3370;Perdida
Zonas Secundarias;Barranquilla 77;2024;sep;367768164;240679514;127088650;190236712;-63148062;13;27;495;2426;3370;Perdida
Zonas Secundarias;Barranquilla 77;2024;oct;385559732;207648788;177910944;157000587;20910357;13;22;561;2364;2890;Baja
Zonas Secundarias;Barranquilla 77;2024;nov;323689638;231463207;92226431;191949244;-99722813;12;22;453;1908;2730;Perdida
Zonas Secundarias;Barranquilla 77;2024;dic;414054182;222191853;191862329;210182740;-18320411;12;22;553;1941;2730;Perdida
Zonas Secundarias;Barranquilla Circunvalar;2021;ene;74691349;48269176;26422173;24157676;2264497;1;9;153;695;680;Baja
Zonas Secundarias;Barranquilla Circunvalar;2021;feb;97038469;52462426;44576043;20699851;23876192;1;9;170;910;680;Media
Zonas Secundarias;Barranquilla Circunvalar;2021;mar;134703384;62023847;72679537;27797127;44882410;2;9;226;1184;680;Media
Zonas Secundarias;Barranquilla Circunvalar;2021;abr;97712927;46948715;50764212;15845303;34918909;2;9;174;867;680;Media
Zonas Secundarias;Barranquilla Circunvalar;2021;may;108034061;52652997;55381064;20321162;35059902;2;10;173;918;680;Media
Zonas Secundarias;Barranquilla Circunvalar;2021;jun;100482780;53525274;46957506;20470952;26486554;2;9;162;892;680;Media
Zonas Secundarias;Barranquilla Circunvalar;2021;jul;113686858;60145110;53541748;25232816;28308932;2;9;194;961;680;Media
Zonas Secundarias;Barranquilla Circunvalar;2021;ago;132537004;62933625;69603379;52394781;17208598;1;9;240;1258;680;Baja
Zonas Secundarias;Barranquilla Circunvalar;2021;sep;148310711;64722954;83587757;24996182;58591575;1;9;261;1345;680;Media
Zonas Secundarias;Barranquilla Circunvalar;2021;oct;132356847;63478416;68878431;19605964;49272467;1;9;231;1209;680;Media
Zonas Secundarias;Barranquilla Circunvalar;2021;nov;131752516;60872106;70880410;59396302;11484108;1;8;228;1216;680;Baja
Zonas Secundarias;Barranquilla Circunvalar;2021;dic;109774956;52541714;57233242;72976963;-15743721;1;8;175;1007;680;Perdida
Zonas Secundarias;Barranquilla Circunvalar;2022;ene;69782101;48301340;21480761;15909623;5571138;1;8;112;625;680;Baja
Zonas Secundarias;Barranquilla Circunvalar;2022;feb;92869828;53254563;39615265;21716468;17898797;2;8;163;850;680;Baja
Zonas Secundarias;Barranquilla Circunvalar;2022;mar;89889836;48641454;41248382;15050038;26198344;2;9;147;736;680;Media
Zonas Secundarias;Barranquilla Circunvalar;2022;abr;88591183;52027453;36563730;18219582;18344148;2;10;128;705;680;Baja
Zonas Secundarias;Barranquilla Circunvalar;2022;may;115941077;55935687;60005390;21656415;38348975;2;11;176;948;840;Media
Zonas Secundarias;Barranquilla Circunvalar;2022;jun;167382387;72826139;94556248;24007835;70548413;2;11;219;1308;840;Media
Zonas Secundarias;Barranquilla Circunvalar;2022;jul;108255146;59749780;48505366;21983693;26521673;2;11;166;883;840;Media
Zonas Secundarias;Barranquilla Circunvalar;2022;ago;67508466;45527820;21980646;32102087;-10121441;1;10;98;509;680;Perdida
Zonas Secundarias;Barranquilla Circunvalar;2022;sep;97383248;52839701;44543547;34639519;9904028;2;8;187;678;680;Baja
Zonas Secundarias;Barranquilla Circunvalar;2022;oct;109174472;67193092;41981380;22471623;19509757;2;7;207;648;520;Baja
Zonas Secundarias;Barranquilla Circunvalar;2022;nov;93562846;48422205;45140641;54601832;-9461191;2;10;195;606;1640;Perdida
Zonas Secundarias;Barranquilla Circunvalar;2022;dic;117157663;58717848;58439815;27738901;30700914;2;11;224;726;1000;Media
Zonas Secundarias;Barranquilla Circunvalar;2023;ene;126629644;76729620;49900024;40668711;9231313;2;11;245;782;1000;Baja
Zonas Secundarias;Barranquilla Circunvalar;2023;feb;99695563;60897413;38798150;28039078;10759072;2;11;190;574;1000;Baja
Zonas Secundarias;Barranquilla Circunvalar;2023;mar;162649676;91091573;71558103;92299699;-20741596;3;11;296;974;1000;Perdida
Zonas Secundarias;Barranquilla Circunvalar;2023;abr;151003874;78297444;72706430;49925834;22780596;3;12;239;824;1000;Baja
Zonas Secundarias;Barranquilla Circunvalar;2023;may;161216972;89062671;72154301;110556439;-38402138;3;12;297;903;1000;Perdida
Zonas Secundarias;Barranquilla Circunvalar;2023;jun;150090769;79029391;71061378;58072028;12989350;3;10;252;869;1000;Baja
Zonas Secundarias;Barranquilla Circunvalar;2023;jul;309898532;185926719;123971813;120312189;3659624;3;10;296;2294;1000;Baja
Zonas Secundarias;Barranquilla Circunvalar;2023;ago;419748604;195769758;223978846;107498946;116479900;11;24;389;3278;3240;Media
Zonas Secundarias;Barranquilla Circunvalar;2023;sep;472815042;249164827;223650215;123063687;100586528;11;23;434;3509;3040;Baja
Zonas Secundarias;Barranquilla Circunvalar;2023;oct;384947106;191725650;193221456;135088789;58132667;11;22;371;2890;2880;Baja
Zonas Secundarias;Barranquilla Circunvalar;2023;nov;445197796;239162215;206035581;129949332;76086249;11;22;481;3684;2880;Baja
Zonas Secundarias;Barranquilla Circunvalar;2023;dic;372904484;209394353;163510131;105695492;57814639;11;22;432;2678;2880;Baja
Zonas Secundarias;Barranquilla Circunvalar;2024;ene;410778302;234805604;175972698;163726408;12246290;11;21;370;3084;2720;Baja
Zonas Secundarias;Barranquilla Circunvalar;2024;feb;363697775;158722474;204975301;110991434;93983867;11;21;318;2673;2720;Media
Zonas Secundarias;Barranquilla Circunvalar;2024;mar;398641130;221484063;177157067;182352830;-5195763;11;21;429;2967;2720;Perdida
Zonas Secundarias;Barranquilla Circunvalar;2024;abr;517413017;200493429;316919588;188494707;128424881;10;21;545;3526;2560;Media
Zonas Secundarias;Barranquilla Circunvalar;2024;may;464667404;249959164;214708240;200360330;14347910;10;20;443;3280;2560;Baja
Zonas Secundarias;Barranquilla Circunvalar;2024;jun;467623204;192488639;275134565;185712042;89422523;11;20;402;3187;2560;Baja
Zonas Secundarias;Barranquilla Circunvalar;2024;jul;411024207;240253281;170770926;150832472;19938454;11;21;396;2812;2720;Baja
Zonas Secundarias;Barranquilla Circunvalar;2024;ago;396820017;194077463;202742554;181252810;21489744;11;21;405;2553;2720;Baja
Zonas Secundarias;Barranquilla Circunvalar;2024;sep;469939319;218530506;251408813;185530000;65878813;11;22;400;3310;2560;Baja
Zonas Secundarias;Barranquilla Circunvalar;2024;oct;481755017;190859392;290895625;180545433;110350192;11;24;387;3359;2880;Media
Zonas Secundarias;Barranquilla Circunvalar;2024;nov;431509517;205744988;225764529;171030593;54733936;10;25;383;2646;2880;Baja
Zonas Secundarias;Barranquilla Circunvalar;2024;dic;472701491;400492970;72208521;219624833;-147416312;11;26;450;2945;3040;Perdida
Zonas Secundarias;Barranquilla Prado;2021;ene;94755158;30645345;64109813;34822257;29287556;3;3;227;585;570;Media
Zonas Secundarias;Barranquilla Prado;2021;feb;72049206;25538693;46510513;42528852;3981661;3;4;188;423;570;Baja
Zonas Secundarias;Barranquilla Prado;2021;mar;106272800;32363137;73909663;50108591;23801072;3;4;256;679;570;Media
Zonas Secundarias;Barranquilla Prado;2021;abr;65934471;24720218;41214253;37450949;3763304;3;4;147;403;570;Baja
Zonas Secundarias;Barranquilla Prado;2021;may;62693561;22984362;39709199;38481056;1228143;3;4;180;383;570;Baja
Zonas Secundarias;Barranquilla Prado;2021;jun;110666058;36888344;73777714;44406211;29371503;3;4;262;745;570;Media
Zonas Secundarias;Barranquilla Prado;2021;jul;106751130;37673597;69077533;51986418;17091115;3;4;281;711;570;Baja
Zonas Secundarias;Barranquilla Prado;2021;ago;91814724;30576461;61238263;36305823;24932440;3;4;255;585;570;Media
Zonas Secundarias;Barranquilla Prado;2021;sep;89981896;31941700;58040196;34372373;23667823;3;4;246;554;570;Media
Zonas Secundarias;Barranquilla Prado;2021;oct;89233721;29038326;60195395;42725259;17470136;4;4;259;517;570;Baja
Zonas Secundarias;Barranquilla Prado;2021;nov;90228187;34938770;55289417;60363508;-5074091;4;4;247;494;570;Perdida
Zonas Secundarias;Barranquilla Prado;2021;dic;105732089;33786311;71945778;50494683;21451095;4;4;312;603;570;Baja
Zonas Secundarias;Barranquilla Prado;2022;ene;94656375;35373510;59282865;40046926;19235939;4;4;265;504;570;Baja
Zonas Secundarias;Barranquilla Prado;2022;feb;88678299;31504887;57173412;39279086;17894326;5;4;271;488;570;Baja
Zonas Secundarias;Barranquilla Prado;2022;mar;109039351;34727859;74311492;45098147;29213345;5;4;285;590;570;Media
Zonas Secundarias;Barranquilla Prado;2022;abr;111221994;36680929;74541065;40942147;33598918;5;4;313;594;570;Media
Zonas Secundarias;Barranquilla Prado;2022;may;110096214;35826200;74270014;44824755;29445259;5;4;286;572;570;Media
Zonas Secundarias;Barranquilla Prado;2022;jun;107735597;36638036;71097561;47207769;23889792;5;4;277;552;570;Media
Zonas Secundarias;Barranquilla Prado;2022;jul;115860415;39223454;76636961;49466601;27170360;5;4;310;575;570;Media
Zonas Secundarias;Barranquilla Prado;2022;ago;139410161;48297352;91112809;58196782;32916027;4;5;354;727;570;Media
Zonas Secundarias;Barranquilla Prado;2022;sep;111929593;41569198;70360395;66347684;4012711;4;5;320;562;570;Baja
Zonas Secundarias;Barranquilla Prado;2022;oct;107433420;39224290;68209130;38423120;29786010;4;5;297;536;570;Media
Zonas Secundarias;Barranquilla Prado;2022;nov;104339912;36503887;67836025;67167320;668705;4;4;259;535;570;Perdida
Zonas Secundarias;Barranquilla Prado;2022;dic;109973690;30452614;79521076;53046745;26474331;3;6;307;563;570;Media
Zonas Secundarias;Barranquilla Prado;2023;ene;75609283;36704881;38904402;39592697;-688295;3;6;202;338;570;Perdida
Zonas Secundarias;Barranquilla Prado;2023;feb;83131833;36349085;46782748;49978333;-3195585;3;5;222;385;570;Perdida
Zonas Secundarias;Barranquilla Prado;2023;mar;133037643;50942563;82095080;41623946;40471134;3;5;313;624;570;Media
Zonas Secundarias;Barranquilla Prado;2023;abr;106770941;41064947;65705994;44343630;21362364;4;5;242;477;570;Baja
Zonas Secundarias;Barranquilla Prado;2023;may;105534343;47730292;57804051;48413482;9390569;4;5;255;505;570;Baja
Zonas Secundarias;Barranquilla Prado;2023;jun;106707002;43355693;63351309;52359497;10991812;4;4;258;505;570;Baja
Zonas Secundarias;Barranquilla Prado;2023;jul;113267660;45060730;68206930;73018448;-4811518;5;4;279;548;570;Perdida
Zonas Secundarias;Barranquilla Prado;2023;ago;110978901;45578024;65400877;62279314;3121563;5;4;259;512;570;Baja
Zonas Secundarias;Barranquilla Prado;2023;sep;92558092;35121373;57436719;65556863;-8120144;5;4;223;458;570;Perdida
Zonas Secundarias;Barranquilla Prado;2023;oct;94922034;38084402;56837632;67468592;-10630960;4;4;237;449;570;Perdida
Zonas Secundarias;Barranquilla Prado;2023;nov;112954230;47857886;65096344;58833359;6262985;5;4;270;517;570;Baja
Zonas Secundarias;Barranquilla Prado;2023;dic;114037689;34896474;79141215;56495132;22646083;5;4;284;496;570;Baja
Zonas Secundarias;Barranquilla Prado;2024;ene;121926805;44466085;77460720;58967290;18493430;4;4;263;561;570;Baja
Zonas Secundarias;Barranquilla Prado;2024;feb;70630073;31868087;38761986;46246906;-7484920;4;4;137;291;570;Perdida
Zonas Secundarias;Barranquilla Prado;2024;mar;22351355;20649710;1701645;57494071;-55792426;4;4;58;82;570;Perdida
Zonas Secundarias;Barranquilla Prado;2024;abr;5495348;11692369;-6197021;84222266;-90419287;3;4;3;5;570;Perdida
Zonas Secundarias;Barranquilla Prado;2024;may;674062;19158586;-18484524;41051854;-59536378;4;4;1;1;570;Perdida
Zonas Secundarias;Barranquilla Prado;2024;jun;97355812;51981078;45374734;71413029;-26038295;4;4;184;418;570;Perdida
Zonas Secundarias;Barranquilla Prado;2024;jul;112039863;44875995;67163868;60495599;6668269;4;4;222;490;570;Baja
Zonas Secundarias;Barranquilla Prado;2024;ago;106894814;41258164;65636650;55967115;9669535;4;4;205;492;570;Baja
Zonas Secundarias;Barranquilla Prado;2024;sep;99179826;39655776;59524050;66201174;-6677124;6;4;205;428;570;Perdida
Zonas Secundarias;Barranquilla Prado;2024;oct;119001647;55712158;63289489;42137748;21151741;4;6;239;536;730;Baja
Zonas Secundarias;Barranquilla Prado;2024;nov;111850627;52645397;59205230;52289963;6915267;5;6;212;484;730;Baja
Zonas Secundarias;Barranquilla Prado;2024;dic;157270910;59121397;98149513;58512375;39637138;5;6;251;635;730;Media
Zonas Secundarias;Cartagena;2021;ene;218399588;130402200;87997388;128773397;-40776009;11;15;396;1642;1980;Perdida
Zonas Secundarias;Cartagena;2021;feb;235579447;107600771;127978676;96527624;31451052;10;14;379;1945;1840;Baja
Zonas Secundarias;Cartagena;2021;mar;280859129;124555910;156303219;123347712;32955507;9;15;438;2524;1980;Baja
Zonas Secundarias;Cartagena;2021;abr;237367599;116827239;120540360;103567999;16972361;8;15;416;2058;1980;Baja
Zonas Secundarias;Cartagena;2021;may;182551883;111946675;70605208;107871428;-37266220;8;16;313;1558;1980;Perdida
Zonas Secundarias;Cartagena;2021;jun;249101509;121747183;127354326;104914745;22439581;8;17;405;2099;1980;Baja
Zonas Secundarias;Cartagena;2021;jul;258894064;123585832;135308232;123614254;11693978;8;17;440;2215;1980;Baja
Zonas Secundarias;Cartagena;2021;ago;254643987;120959186;133684801;116089982;17594819;8;18;419;2221;1980;Baja
Zonas Secundarias;Cartagena;2021;sep;273529721;135501609;138028112;122132664;15895448;9;17;435;2340;1980;Baja
Zonas Secundarias;Cartagena;2021;oct;272143754;124183441;147960313;134000955;13959358;9;17;440;2311;1820;Baja
Zonas Secundarias;Cartagena;2021;nov;277107165;128805139;148302026;123283352;25018674;10;17;432;2374;1980;Baja
Zonas Secundarias;Cartagena;2021;dic;255612785;119919142;135693643;131144323;4549320;10;18;431;2226;1980;Baja
Zonas Secundarias;Cartagena;2022;ene;235186405;118326019;116860386;109105356;7755030;10;18;394;1980;1980;Baja
Zonas Secundarias;Cartagena;2022;feb;268601754;125704739;142897015;121871435;21025580;10;18;387;2382;1980;Baja
Zonas Secundarias;Cartagena;2022;mar;267236350;130244143;136992207;109736307;27255900;10;20;386;2182;1980;Baja
Zonas Secundarias;Cartagena;2022;abr;273701583;137966146;135735437;139421704;-3686267;10;21;361;2251;2140;Perdida
Zonas Secundarias;Cartagena;2022;may;265862537;127257864;138604673;135107012;3497661;11;20;392;2119;2140;Baja
Zonas Secundarias;Cartagena;2022;jun;289032208;136157197;152875011;120919581;31955430;11;20;374;2386;2140;Baja
Zonas Secundarias;Cartagena;2022;jul;261042311;134019935;127022376;132208192;-5185816;10;19;395;1841;2140;Perdida
Zonas Secundarias;Cartagena;2022;ago;275374688;150189238;125185450;143670231;-18484781;11;19;402;2194;2140;Perdida
Zonas Secundarias;Cartagena;2022;sep;266598574;134583100;132015474;130321919;1693555;9;18;351;2074;1980;Perdida
Zonas Secundarias;Cartagena;2022;oct;212505068;117572400;94932668;110768744;-15836076;10;18;308;1509;1980;Perdida
Zonas Secundarias;Cartagena;2022;nov;256262685;122415163;133847522;95825746;38021776;14;16;363;2009;2460;Baja
Zonas Secundarias;Cartagena;2022;dic;305439655;123971669;181467986;169164605;12303381;10;20;433;2150;1980;Baja
Zonas Secundarias;Cartagena;2023;ene;331947656;152766418;179181238;125262929;53918309;11;20;403;2653;2180;Baja
Zonas Secundarias;Cartagena;2023;feb;290363836;156254633;134109203;122517377;11591826;10;20;395;2095;2340;Baja
Zonas Secundarias;Cartagena;2023;mar;345833817;178019180;167814637;131487458;36327179;10;21;389;2636;2540;Baja
Zonas Secundarias;Cartagena;2023;abr;281224941;158037561;123187380;100118992;23068388;9;21;354;1957;2540;Baja
Zonas Secundarias;Cartagena;2023;may;292323078;160127515;132195563;163264221;-31068658;9;21;356;2182;2540;Perdida
Zonas Secundarias;Cartagena;2023;jun;276262839;156049699;120213140;163041782;-42828642;10;20;359;2038;2340;Perdida
Zonas Secundarias;Cartagena;2023;jul;296659947;174576280;122083667;145945320;-23861653;10;21;369;2078;2500;Perdida
Zonas Secundarias;Cartagena;2023;ago;308807049;179354176;129452873;149632143;-20179270;8;24;386;2125;2500;Perdida
Zonas Secundarias;Cartagena;2023;sep;325179695;145881420;179298275;130597425;48700850;8;22;432;2205;2180;Baja
Zonas Secundarias;Cartagena;2023;oct;241996974;165769098;76227876;164168977;-87941101;9;21;346;1589;2180;Perdida
Zonas Secundarias;Cartagena;2023;nov;322151677;166616031;155535646;159345152;-3809506;10;20;391;2114;2020;Perdida
Zonas Secundarias;Cartagena;2023;dic;342026178;168335223;173690955;165247630;8443325;10;20;416;2145;2020;Baja
Zonas Secundarias;Cartagena;2024;ene;308292925;174463048;133829877;139052566;-5222689;10;19;384;2084;2020;Perdida
Zonas Secundarias;Cartagena;2024;feb;303404124;157737354;145666770;136719644;8947126;10;17;342;1946;2020;Baja
Zonas Secundarias;Cartagena;2024;mar;283769599;157723930;126045669;156071784;-30026115;10;16;378;1687;2020;Perdida
Zonas Secundarias;Cartagena;2024;abr;353811916;173053766;180758150;165739515;15018635;10;20;389;2314;2180;Baja
Zonas Secundarias;Cartagena;2024;may;341354501;170151152;171203349;148474599;22728750;10;20;360;2270;2180;Baja
Zonas Secundarias;Cartagena;2024;jun;267879217;166708648;101170569;145931968;-44761399;10;21;319;1395;2340;Perdida
Zonas Secundarias;Cartagena;2024;jul;326905566;205890650;121014916;172422726;-51407810;10;20;411;2021;2180;Perdida
Zonas Secundarias;Cartagena;2024;ago;368698152;180575032;188123120;169944403;18178717;10;22;395;2289;2500;Baja
Zonas Secundarias;Cartagena;2024;sep;293565142;159602138;133963004;146532964;-12569960;10;20;311;1757;2500;Perdida
Zonas Secundarias;Cartagena;2024;oct;311728412;161517212;150211200;149752622;458578;9;18;358;2016;2340;Perdida
Zonas Secundarias;Cartagena;2024;nov;281046935;131826049;149220886;149948495;-727609;9;19;291;1775;2340;Perdida
Zonas Secundarias;Cartagena;2024;dic;338419579;174144138;164275441;143283852;20991589;10;19;347;1958;2340;Baja
Zonas Secundarias;Cartagena Express;2021;ene;73021839;30705183;42316656;18219388;24097268;0;4;187;407;570;Media
Zonas Secundarias;Cartagena Express;2021;feb;67778005;34265841;33512164;19476910;14035254;1;4;180;365;570;Baja
Zonas Secundarias;Cartagena Express;2021;mar;64417396;28859336;35558060;19960431;15597629;1;4;193;413;570;Media
Zonas Secundarias;Cartagena Express;2021;abr;68596631;31290519;37306112;19309028;17997084;1;4;197;433;570;Media
Zonas Secundarias;Cartagena Express;2021;may;49829506;25915236;23914270;18582468;5331802;1;4;168;338;570;Baja
Zonas Secundarias;Cartagena Express;2021;jun;58987653;27466839;31520814;21715058;9805756;1;3;189;365;570;Baja
Zonas Secundarias;Cartagena Express;2021;jul;67611860;27979407;39632453;18177719;21454734;1;3;196;392;570;Media
Zonas Secundarias;Cartagena Express;2021;ago;78019388;30205967;47813421;20143077;27670344;1;3;229;490;570;Media
Zonas Secundarias;Cartagena Express;2021;sep;81998548;29462042;52536506;19226701;33309805;1;3;229;524;570;Media
Zonas Secundarias;Cartagena Express;2021;oct;85566307;29576476;55989831;25621242;30368589;1;4;237;551;570;Media
Zonas Secundarias;Cartagena Express;2021;nov;80799440;33316490;47482950;25833447;21649503;1;4;233;490;570;Media
Zonas Secundarias;Cartagena Express;2021;dic;81260708;28582418;52678290;26702379;25975911;1;4;233;503;570;Media
Zonas Secundarias;Cartagena Express;2022;ene;70996134;32168898;38827236;22135253;16691983;1;4;224;431;570;Media
Zonas Secundarias;Cartagena Express;2022;feb;80161699;30667056;49494643;13678502;35816141;1;4;229;488;570;Alta
Zonas Secundarias;Cartagena Express;2022;mar;90104869;38752386;51352483;22204126;29148357;1;4;265;544;570;Media
Zonas Secundarias;Cartagena Express;2022;abr;83725866;34095472;49630394;18707983;30922411;1;4;232;500;570;Media
Zonas Secundarias;Cartagena Express;2022;may;109059339;44997872;64061467;20861931;43199536;1;4;281;622;570;Media
Zonas Secundarias;Cartagena Express;2022;jun;90616375;37446502;53169873;20134490;33035383;1;4;254;523;570;Media
Zonas Secundarias;Cartagena Express;2022;jul;94840961;39356842;55484119;20536835;34947284;1;4;255;529;570;Media
Zonas Secundarias;Cartagena Express;2022;ago;93024825;35976902;57047923;28970073;28077850;1;5;235;522;570;Media
Zonas Secundarias;Cartagena Express;2022;sep;115275898;48555319;66720579;19693293;47027286;1;6;305;656;570;Media
Zonas Secundarias;Cartagena Express;2022;oct;111499727;50345188;61154539;21692130;39462409;1;6;271;594;570;Media
Zonas Secundarias;Cartagena Express;2022;nov;108020205;56589446;51430759;16690840;34739919;1;6;284;586;570;Media
Zonas Secundarias;Cartagena Express;2022;dic;125580831;44477712;81103119;23589902;57513217;1;6;283;695;570;Alta
Zonas Secundarias;Cartagena Express;2023;ene;134317609;61652377;72665232;21643301;51021931;1;6;325;684;570;Media
Zonas Secundarias;Cartagena Express;2023;feb;149505924;65184391;84321533;26313630;58007903;1;6;333;852;570;Media
Zonas Secundarias;Cartagena Express;2023;mar;139451861;66717564;72734297;20118880;52615417;1;6;345;777;570;Media
Zonas Secundarias;Cartagena Express;2023;abr;123741004;58972645;64768359;25829311;38939048;2;6;293;649;570;Media
Zonas Secundarias;Cartagena Express;2023;may;127278100;66850809;60427291;33629485;26797806;2;6;264;618;570;Baja
Zonas Secundarias;Cartagena Express;2023;jun;134587803;66848470;67739333;24016139;43723194;2;6;349;676;570;Media
Zonas Secundarias;Cartagena Express;2023;jul;124150498;54092441;70058057;41449380;28608677;2;6;279;657;570;Media
Zonas Secundarias;Cartagena Express;2023;ago;81746176;42481761;39264415;28457351;10807064;2;5;187;386;570;Baja
Zonas Secundarias;Cartagena Express;2023;sep;98769633;42121286;56648347;26468997;30179350;2;5;237;493;570;Media
Zonas Secundarias;Cartagena Express;2023;oct;96442154;45404348;51037806;27298363;23739443;2;5;228;487;570;Media
Zonas Secundarias;Cartagena Express;2023;nov;91526219;45630173;45896046;31736972;14159074;1;5;219;430;570;Baja
Zonas Secundarias;Cartagena Express;2023;dic;112005231;35198522;76806709;36805868;40000841;1;5;283;521;570;Media
Zonas Secundarias;Cartagena Express;2024;ene;103851916;52052234;51799682;25670196;26129486;1;5;247;469;570;Media
Zonas Secundarias;Cartagena Express;2024;feb;108702863;52873381;55829482;26887593;28941889;1;5;240;501;570;Media
Zonas Secundarias;Cartagena Express;2024;mar;77076454;43496889;33579565;25340780;8238785;1;4;167;335;410;Baja
Zonas Secundarias;Cartagena Express;2024;abr;75128739;35518890;39609849;20071019;19538830;1;4;143;266;410;Media
Zonas Secundarias;Cartagena Express;2024;may;68443500;39017599;29425901;29862042;-436141;1;4;113;229;410;Perdida
Zonas Secundarias;Cartagena Express;2024;jun;89704939;66273587;23431352;51371248;-27939896;2;4;147;293;410;Perdida
Zonas Secundarias;Cartagena Express;2024;jul;74949603;34273783;40675820;24582329;16093491;2;4;127;253;410;Baja
Zonas Secundarias;Cartagena Express;2024;ago;73362957;41025215;32337742;31724097;613645;2;4;136;273;410;Perdida
Zonas Secundarias;Cartagena Express;2024;sep;79271837;41269881;38001956;40881580;-2879624;2;4;151;300;410;Perdida
Zonas Secundarias;Cartagena Express;2024;oct;96525931;40952687;55573244;39854551;15718693;1;4;153;402;410;Baja
Zonas Secundarias;Cartagena Express;2024;nov;73879489;31997621;41881868;42175611;-293743;1;4;129;304;410;Perdida
Zonas Secundarias;Cartagena Express;2024;dic;68096727;27991389;40105338;24512579;15592759;1;4;128;256;410;Media
Zonas Secundarias;Cuestecitas;2021;ene;201734153;103391313;98342840;59725219;38617621;4;20;408;1544;2920;Baja
Zonas Secundarias;Cuestecitas;2021;feb;185565727;110542091;75023636;52479194;22544442;4;19;372;1354;2760;Baja
Zonas Secundarias;Cuestecitas;2021;mar;183748391;110199243;73549148;58604952;14944196;4;17;400;1370;2440;Baja
Zonas Secundarias;Cuestecitas;2021;abr;215482183;123352260;92129923;65507235;26622688;4;19;473;1594;2920;Baja
Zonas Secundarias;Cuestecitas;2021;may;237024583;138201358;98823225;60253677;38569548;4;20;418;1919;2920;Baja
Zonas Secundarias;Cuestecitas;2021;jun;202536676;130547587;71989089;59032757;12956332;4;21;457;1748;3240;Baja
Zonas Secundarias;Cuestecitas;2021;jul;223984744;136559778;87424966;71776368;15648598;4;21;493;1547;3240;Baja
Zonas Secundarias;Cuestecitas;2021;ago;224426879;131073103;93353776;81434887;11918889;4;20;464;1844;3040;Baja
Zonas Secundarias;Cuestecitas;2021;sep;217847244;129858504;87988740;65707667;22281073;4;18;439;1799;2720;Baja
Zonas Secundarias;Cuestecitas;2021;oct;251300156;129942906;121357250;64144994;57212256;4;18;492;2065;2720;Media
Zonas Secundarias;Cuestecitas;2021;nov;208787292;122672697;86114595;74273410;11841185;4;18;411;1655;2880;Baja
Zonas Secundarias;Cuestecitas;2021;dic;243147237;153032372;90114865;72466849;17648016;4;18;477;1950;2880;Baja
Zonas Secundarias;Cuestecitas;2022;ene;234258982;124200714;110058268;60969412;49088856;4;18;450;1725;2880;Baja
Zonas Secundarias;Cuestecitas;2022;feb;229234730;137186954;92047776;51287211;40760565;4;18;428;1712;2880;Baja
Zonas Secundarias;Cuestecitas;2022;mar;238594162;137975092;100619070;62719140;37899930;4;18;496;1782;2880;Baja
Zonas Secundarias;Cuestecitas;2022;abr;241723128;142079419;99643709;54137073;45506636;4;17;490;1756;2720;Baja
Zonas Secundarias;Cuestecitas;2022;may;249063741;135981518;113082223;64299441;48782782;4;17;514;1896;2720;Baja
Zonas Secundarias;Cuestecitas;2022;jun;274935742;146029020;128906722;51451334;77455388;4;17;527;2053;2720;Media
Zonas Secundarias;Cuestecitas;2022;jul;255740866;151939835;103801031;65212667;38588364;3;16;466;1761;2560;Baja
Zonas Secundarias;Cuestecitas;2022;ago;239674692;150347792;89326900;71079242;18247658;5;18;450;1666;2880;Baja
Zonas Secundarias;Cuestecitas;2022;sep;286596508;160237810;126358698;66361610;59997088;5;18;522;2107;2880;Baja
Zonas Secundarias;Cuestecitas;2022;oct;258718837;153006700;105712137;59242435;46469702;4;19;530;1974;3040;Baja
Zonas Secundarias;Cuestecitas;2022;nov;277404683;146326193;131078490;87111330;43967160;4;19;524;2097;3040;Baja
Zonas Secundarias;Cuestecitas;2022;dic;287210095;174248346;112961749;49231048;63730701;4;19;492;2084;2880;Media
Zonas Secundarias;Cuestecitas;2023;ene;280592517;127699829;152892688;67409397;85483291;4;19;476;2163;2880;Media
Zonas Secundarias;Cuestecitas;2023;feb;281785412;155031336;126754076;55956063;70798013;4;19;484;2039;2880;Media
Zonas Secundarias;Cuestecitas;2023;mar;290422292;165499865;124922427;72572526;52349901;4;18;478;1940;2720;Baja
Zonas Secundarias;Cuestecitas;2023;abr;289090295;158318251;130772044;76328693;54443351;4;18;442;1949;2720;Baja
Zonas Secundarias;Cuestecitas;2023;may;291627773;205787544;85840229;96811085;-10970856;4;18;489;1985;2720;Perdida
Zonas Secundarias;Cuestecitas;2023;jun;294203017;177443668;116759349;99656859;17102490;4;18;492;1800;2880;Baja
Zonas Secundarias;Cuestecitas;2023;jul;284279389;166201783;118077606;65981724;52095882;4;18;484;1971;2880;Baja
Zonas Secundarias;Cuestecitas;2023;ago;294547705;193676200;100871505;84884023;15987482;4;16;480;1970;2560;Baja
Zonas Secundarias;Cuestecitas;2023;sep;316105997;164731509;151374488;74222695;77151793;4;17;506;2102;2720;Media
Zonas Secundarias;Cuestecitas;2023;oct;293644779;160595994;133048785;68540731;64508054;5;16;433;2157;2560;Baja
Zonas Secundarias;Cuestecitas;2023;nov;283066632;159630278;123436354;51157179;72279175;5;17;458;2139;2720;Media
Zonas Secundarias;Cuestecitas;2023;dic;256093063;141398560;114694503;73998996;40695507;5;17;359;1831;2720;Baja
Zonas Secundarias;Cuestecitas;2024;ene;273664717;166005517;107659200;69693366;37965834;4;17;405;1915;2720;Baja
Zonas Secundarias;Cuestecitas;2024;feb;255854364;154385433;101468931;66103512;35365419;5;18;362;1729;2880;Baja
Zonas Secundarias;Cuestecitas;2024;mar;258747570;159963595;98783975;90179160;8604815;5;18;375;1790;2880;Baja
Zonas Secundarias;Cuestecitas;2024;abr;290407092;176532829;113874263;74131301;39742962;5;17;410;1838;2720;Baja
Zonas Secundarias;Cuestecitas;2024;may;284517646;169640662;114876984;65683837;49193147;5;15;415;1764;2400;Baja
Zonas Secundarias;Cuestecitas;2024;jun;332545482;165511884;167033598;68736726;98296872;5;16;473;2034;2560;Media
Zonas Secundarias;Cuestecitas;2024;jul;317010762;203591821;113418941;72910830;40508111;5;16;433;2042;2560;Baja
Zonas Secundarias;Cuestecitas;2024;ago;359194497;222851668;136342829;77882642;58460187;5;18;483;2228;2880;Baja
Zonas Secundarias;Cuestecitas;2024;sep;363943419;214868897;149074522;70751458;78323064;5;21;487;2504;3360;Baja
Zonas Secundarias;Cuestecitas;2024;oct;359660409;186924694;172735715;88358829;84376886;5;22;439;2530;3520;Media
Zonas Secundarias;Cuestecitas;2024;nov;323022164;185892779;137129385;75673859;61455526;5;22;395;2270;3520;Baja
Zonas Secundarias;Cuestecitas;2024;dic;280869982;213523405;67346577;107474301;-40127724;6;22;423;1885;3520;Perdida
Zonas Secundarias;La Loma;2021;ene;36323788;14158407;22165381;9430150;12735231;1;3;70;299;480;Media
Zonas Secundarias;La Loma;2021;feb;27803114;17875761;9927353;11322591;-1395238;1;3;49;191;480;Perdida
Zonas Secundarias;La Loma;2021;mar;35756668;20012433;15744235;13941856;1802379;1;3;77;280;480;Baja
Zonas Secundarias;La Loma;2021;abr;23519837;14966837;8553000;14720431;-6167431;1;4;63;184;640;Perdida
Zonas Secundarias;La Loma;2021;may;42625083;17096399;25528684;11657814;13870870;1;2;75;334;320;Media
Zonas Secundarias;La Loma;2021;jun;48852616;23065510;25787106;12399823;13387283;1;2;76;366;320;Media
Zonas Secundarias;La Loma;2021;jul;44624718;22739911;21884807;13951336;7933471;1;2;88;300;320;Baja
Zonas Secundarias;La Loma;2021;ago;46558506;20808728;25749778;13568891;12180887;1;2;94;351;320;Media
Zonas Secundarias;La Loma;2021;sep;53716571;26136632;27579939;12471278;15108661;1;3;93;429;480;Media
Zonas Secundarias;La Loma;2021;oct;29591182;19776838;9814344;19012019;-9197675;1;5;69;260;800;Perdida
Zonas Secundarias;La Loma;2021;nov;33796637;24597665;9198972;19450349;-10251377;1;4;53;280;640;Perdida
Zonas Secundarias;La Loma;2021;dic;29866985;30116789;-249804;18499806;-18749610;1;5;81;239;640;Perdida
Zonas Secundarias;La Loma;2022;ene;33054752;20910880;12143872;18162666;-6018794;1;5;55;278;640;Perdida
Zonas Secundarias;La Loma;2022;feb;41421493;26102651;15318842;13829212;1489630;1;5;70;326;640;Baja
Zonas Secundarias;La Loma;2022;mar;40711876;28205656;12506220;14816090;-2309870;1;5;79;309;640;Perdida
Zonas Secundarias;La Loma;2022;abr;42765359;25586901;17178458;11201483;5976975;1;5;85;377;640;Baja
Zonas Secundarias;La Loma;2022;may;55500593;26938114;28562479;16346400;12216079;1;5;102;454;640;Media
Zonas Secundarias;La Loma;2022;jun;41342363;34746347;6596016;13948967;-7352951;1;5;67;240;640;Perdida
Zonas Secundarias;La Loma;2022;jul;58978431;40713895;18264536;12674003;5590533;1;4;86;259;640;Baja
Zonas Secundarias;La Loma;2022;ago;43857988;32883771;10974217;13551741;-2577524;1;4;54;240;640;Perdida
Zonas Secundarias;La Loma;2022;sep;46167649;30859752;15307897;14610690;697207;1;4;66;266;640;Baja
Zonas Secundarias;La Loma;2022;oct;32356871;16450292;15906579;10922700;4983879;1;3;63;197;480;Baja
Zonas Secundarias;La Loma;2022;nov;54460140;21470237;32989903;13862571;19127332;1;3;75;405;480;Media
Zonas Secundarias;La Loma;2022;dic;56097397;35095721;21001676;21189960;-188284;1;4;87;382;640;Perdida
Zonas Secundarias;La Loma;2023;ene;54862952;24159308;30703644;14617845;16085799;1;4;78;348;640;Media
Zonas Secundarias;La Loma;2023;feb;47424728;31736808;15687920;26998780;-11310860;1;4;78;305;640;Perdida
Zonas Secundarias;La Loma;2023;mar;37138904;25190110;11948794;14904708;-2955914;1;4;68;230;640;Perdida
Zonas Secundarias;La Loma;2023;abr;51749935;32576076;19173859;12071087;7102772;1;4;72;299;640;Baja
Zonas Secundarias;La Loma;2023;may;50644312;39943935;10700377;21168880;-10468503;1;4;65;298;640;Perdida
Zonas Secundarias;La Loma;2023;jun;54116667;32283954;21832713;23354802;-1522089;1;3;78;292;480;Perdida
Zonas Secundarias;La Loma;2023;jul;57032222;32336407;24695815;15686359;9009456;1;3;92;354;480;Baja
Zonas Secundarias;La Loma;2023;ago;61201225;37041635;24159590;11901510;12258080;1;3;94;413;480;Baja
Zonas Secundarias;La Loma;2023;sep;66871754;28386528;38485226;10663501;27821725;1;3;139;443;480;Media
Zonas Secundarias;La Loma;2023;oct;62841981;34448552;28393429;25776809;2616620;1;3;123;410;320;Baja
Zonas Secundarias;La Loma;2023;nov;105444945;43935460;61509485;14777553;46731932;1;4;185;672;480;Alta
Zonas Secundarias;La Loma;2023;dic;90638261;62716147;27922114;51847646;-23925532;1;6;200;653;800;Perdida
Zonas Secundarias;La Loma;2024;ene;91747154;57249544;34497610;25650653;8846957;2;6;184;562;800;Baja
Zonas Secundarias;La Loma;2024;feb;90764044;44282745;46481299;20573284;25908015;2;6;146;633;800;Media
Zonas Secundarias;La Loma;2024;mar;85238520;51774863;33463657;22728421;10735236;2;6;172;655;800;Baja
Zonas Secundarias;La Loma;2024;abr;131445300;75308174;56137126;20075385;36061741;2;5;179;985;800;Media
Zonas Secundarias;La Loma;2024;may;102759079;35995821;66763258;36869581;29893677;2;5;135;852;800;Media
Zonas Secundarias;La Loma;2024;jun;108032718;37140611;70892107;52133758;18758349;2;6;101;430;800;Baja
Zonas Secundarias;La Loma;2024;jul;129986076;46438262;83547814;48729649;34818165;2;6;117;588;890;Media
Zonas Secundarias;La Loma;2024;ago;107964559;61335621;46628938;59888030;-13259092;2;7;113;669;1050;Perdida
Zonas Secundarias;La Loma;2024;sep;117057481;78595328;38462153;74726722;-36264569;2;7;131;993;1050;Perdida
Zonas Secundarias;La Loma;2024;oct;146174347;70273468;75900879;58147605;17753274;2;7;117;1199;1050;Baja
Zonas Secundarias;La Loma;2024;nov;121734408;55258597;66475811;53688498;12787313;2;7;111;1027;1050;Baja
Zonas Secundarias;La Loma;2024;dic;65900194;62522668;3377526;41782762;-38405236;1;6;98;421;1050;Perdida
Zonas Secundarias;Monteria;2021;ene;186127546;87208245;98919301;67735849;31183452;7;14;386;1542;1930;Baja
Zonas Secundarias;Monteria;2021;feb;159199690;78063667;81136023;65764249;15371774;7;14;354;1481;1930;Baja
Zonas Secundarias;Monteria;2021;mar;203131286;95753254;107378032;65589932;41788100;7;14;468;1723;2090;Baja
Zonas Secundarias;Monteria;2021;abr;166507437;82437349;84070088;60000616;24069472;7;16;312;1608;2090;Baja
Zonas Secundarias;Monteria;2021;may;147853115;90789536;57063579;65387248;-8323669;7;15;287;1315;2090;Perdida
Zonas Secundarias;Monteria;2021;jun;186820262;96577971;90242291;69378460;20863831;7;15;383;1603;2090;Baja
Zonas Secundarias;Monteria;2021;jul;214371255;110320821;104050434;82159978;21890456;7;15;435;1756;2090;Baja
Zonas Secundarias;Monteria;2021;ago;217765573;107718161;110047412;67061023;42986389;7;16;421;1923;2090;Baja
Zonas Secundarias;Monteria;2021;sep;205438133;107459670;97978463;73744591;24233872;7;17;416;1740;2250;Baja
Zonas Secundarias;Monteria;2021;oct;194760706;101999061;92761645;76338360;16423285;7;17;382;1726;2410;Baja
Zonas Secundarias;Monteria;2021;nov;184898938;92868334;92030604;71195139;20835465;7;17;414;1669;2410;Baja
Zonas Secundarias;Monteria;2021;dic;178024833;90856682;87168151;93079130;-5910979;7;17;433;1466;2410;Perdida
Zonas Secundarias;Monteria;2022;ene;165967923;94541319;71426604;68986624;2439980;7;17;389;1337;2410;Baja
Zonas Secundarias;Monteria;2022;feb;214211023;102070331;112140692;70549952;41590740;7;18;425;1815;2410;Baja
Zonas Secundarias;Monteria;2022;mar;257468091;130386792;127081299;67196860;59884439;6;18;499;2126;2410;Media
Zonas Secundarias;Monteria;2022;abr;217904337;115729799;102174538;71785595;30388943;7;18;407;1656;2410;Baja
Zonas Secundarias;Monteria;2022;may;209656592;121302043;88354549;68085551;20268998;7;18;401;1600;2410;Baja
Zonas Secundarias;Monteria;2022;jun;217454455;121216159;96238296;65327734;30910562;7;18;373;1652;2410;Baja
Zonas Secundarias;Monteria;2022;jul;208248095;110146401;98101694;64066553;34035141;7;17;453;1406;2410;Baja
Zonas Secundarias;Monteria;2022;ago;252296118;127747323;124548795;74016765;50532030;7;17;488;1955;2410;Baja
Zonas Secundarias;Monteria;2022;sep;207140390;120111151;87029239;72471507;14557732;6;18;407;1579;2410;Baja
Zonas Secundarias;Monteria;2022;oct;217851064;122354446;95496618;58488661;37007957;7;18;404;1554;2410;Baja
Zonas Secundarias;Monteria;2022;nov;232117280;122731282;109385998;105075995;4310003;7;17;428;1710;2570;Baja
Zonas Secundarias;Monteria;2022;dic;186946383;108303140;78643243;36694390;41948853;6;17;403;1212;2250;Media
Zonas Secundarias;Monteria;2023;ene;228635962;122001480;106634482;76842155;29792327;7;17;369;1689;2250;Baja
Zonas Secundarias;Monteria;2023;feb;233699956;123905120;109794836;72561853;37232983;7;16;342;1704;2250;Baja
Zonas Secundarias;Monteria;2023;mar;235396340;137073675;98322665;82275324;16047341;7;17;374;1670;2500;Baja
Zonas Secundarias;Monteria;2023;abr;165926001;106205886;59720115;60884471;-1164356;7;17;301;1161;2500;Perdida
Zonas Secundarias;Monteria;2023;may;247179929;139747385;107432544;70251518;37181026;7;18;413;1618;2500;Baja
Zonas Secundarias;Monteria;2023;jun;268534020;149282444;119251576;86306127;32945449;7;17;372;1751;2340;Baja
Zonas Secundarias;Monteria;2023;jul;229283653;147252442;82031211;79833802;2197409;7;17;389;1397;2340;Perdida
Zonas Secundarias;Monteria;2023;ago;267766181;144186834;123579347;76024921;47554426;7;17;375;1720;2340;Baja
Zonas Secundarias;Monteria;2023;sep;222239713;104571285;117668428;80097873;37570555;7;15;333;1456;2140;Baja
Zonas Secundarias;Monteria;2023;oct;205140840;120859905;84280935;123939830;-39658895;7;15;342;1278;2140;Perdida
Zonas Secundarias;Monteria;2023;nov;211962488;130085195;81877293;69923403;11953890;7;15;353;1297;2140;Baja
Zonas Secundarias;Monteria;2023;dic;247993784;114985468;133008316;61819289;71189027;8;15;343;1597;2140;Media
Zonas Secundarias;Monteria;2024;ene;199712122;110022756;89689366;72499180;17190186;8;15;305;1173;2140;Baja
Zonas Secundarias;Monteria;2024;feb;221985075;136488433;85496642;122786344;-37289702;8;13;320;1249;1980;Perdida
Zonas Secundarias;Monteria;2024;mar;181906296;117885198;64021098;73119902;-9098804;8;15;282;1027;1980;Perdida
Zonas Secundarias;Monteria;2024;abr;248773116;135663738;113109378;86713753;26395625;9;14;327;1429;1820;Baja
Zonas Secundarias;Monteria;2024;may;201111292;115826467;85284825;94908350;-9623525;9;15;302;1109;1980;Perdida
Zonas Secundarias;Monteria;2024;jun;200571257;131288148;69283109;63574344;5708765;8;15;269;918;1980;Baja
Zonas Secundarias;Monteria;2024;jul;212407956;137316504;75091452;74798618;292834;9;16;337;1045;2140;Perdida
Zonas Secundarias;Monteria;2024;ago;267318860;139505069;127813791;94701861;33111930;9;16;349;1739;2140;Baja
Zonas Secundarias;Monteria;2024;sep;221339986;138578513;82761473;87777232;-5015759;8;16;295;1364;1980;Perdida
Zonas Secundarias;Monteria;2024;oct;252030502;130035195;121995307;74569672;47425635;8;16;325;1336;1980;Baja
Zonas Secundarias;Monteria;2024;nov;239207030;125980665;113226365;70936418;42289947;8;16;292;1404;1980;Baja
Zonas Secundarias;Monteria;2024;dic;228012266;122574415;105437851;76745227;28692624;8;16;299;1127;1980;Baja
Zonas Secundarias;Santa Marta;2021;ene;136681854;66627307;70054547;36253313;33801234;7;12;308;1247;1500;Media
Zonas Secundarias;Santa Marta;2021;feb;169340025;65562756;103777269;41510429;62266840;7;12;283;1604;1500;Media
Zonas Secundarias;Santa Marta;2021;mar;153648559;69335008;84313551;53447686;30865865;7;12;321;1520;1500;Baja
Zonas Secundarias;Santa Marta;2021;abr;134386485;62614115;71772370;50201908;21570462;8;12;234;1162;1500;Baja
Zonas Secundarias;Santa Marta;2021;may;137488058;69969718;67518340;77494485;-9976145;8;12;263;1291;1500;Perdida
Zonas Secundarias;Santa Marta;2021;jun;146503499;81902976;64600523;81123132;-16522609;8;12;277;1393;1300;Perdida
Zonas Secundarias;Santa Marta;2021;jul;176692238;87705534;88986704;78608668;10378036;8;12;362;1475;1300;Baja
Zonas Secundarias;Santa Marta;2021;ago;173033728;80638095;92395633;77619456;14776177;8;13;353;1508;1550;Baja
Zonas Secundarias;Santa Marta;2021;sep;182562766;89277511;93285255;57607445;35677810;7;12;400;1531;1550;Baja
Zonas Secundarias;Santa Marta;2021;oct;221775818;93246879;128528939;76257336;52271603;8;13;390;1967;1710;Media
Zonas Secundarias;Santa Marta;2021;nov;180741722;88948645;91793077;81500328;10292749;8;13;356;1637;1710;Baja
Zonas Secundarias;Santa Marta;2021;dic;219614961;99669094;119945867;122090086;-2144219;8;14;415;2030;1870;Perdida
Zonas Secundarias;Santa Marta;2022;ene;213544566;103434818;110109748;71423206;38686542;8;15;411;1842;2070;Baja
Zonas Secundarias;Santa Marta;2022;feb;220066115;100419290;119646825;75915834;43730991;8;16;369;2087;2070;Baja
Zonas Secundarias;Santa Marta;2022;mar;237166801;107377703;129789098;90433442;39355656;8;17;446;2110;2230;Baja
Zonas Secundarias;Santa Marta;2022;abr;229060126;105370897;123689229;93977425;29711804;7;15;395;1985;2230;Baja
Zonas Secundarias;Santa Marta;2022;may;221009627;103134180;117875447;99709015;18166432;8;15;399;2127;2230;Baja
Zonas Secundarias;Santa Marta;2022;jun;222782682;106536751;116245931;113864107;2381824;8;15;369;2205;2230;Baja
Zonas Secundarias;Santa Marta;2022;jul;235091766;127928710;107163056;97370482;9792574;9;17;419;1798;2230;Baja
Zonas Secundarias;Santa Marta;2022;ago;261923119;121674057;140249062;122821350;17427712;9;16;438;2180;2030;Baja
Zonas Secundarias;Santa Marta;2022;sep;232006957;119323748;112683209;89134085;23549124;9;15;405;1963;2030;Baja
Zonas Secundarias;Santa Marta;2022;oct;239461149;121519923;117941226;83756607;34184619;8;15;453;2046;2030;Baja
Zonas Secundarias;Santa Marta;2022;nov;238547371;174912887;63634484;110101151;-46466667;8;15;451;1995;2030;Perdida
Zonas Secundarias;Santa Marta;2022;dic;223943563;108424733;115518830;111631613;3887217;8;15;417;1686;2030;Baja
Zonas Secundarias;Santa Marta;2023;ene;269276808;124038521;145238287;113951754;31286533;8;15;467;2038;2070;Baja
Zonas Secundarias;Santa Marta;2023;feb;225060705;120225896;104834809;97750101;7084708;8;15;403;1883;2230;Baja
Zonas Secundarias;Santa Marta;2023;mar;282675180;130271499;152403681;102299824;50103857;9;16;462;2189;2230;Baja
Zonas Secundarias;Santa Marta;2023;abr;275508224;148965850;126542374;91196259;35346115;9;16;431;2275;2230;Baja
Zonas Secundarias;Santa Marta;2023;may;287112384;165057139;122055245;90814313;31240932;9;18;431;1994;2430;Baja
Zonas Secundarias;Santa Marta;2023;jun;252653421;144530451;108122970;106318249;1804721;8;18;392;1980;2430;Perdida
Zonas Secundarias;Santa Marta;2023;jul;197150404;131253614;65896790;107910222;-42013432;8;18;358;1339;2430;Perdida
Zonas Secundarias;Santa Marta;2023;ago;283677960;147152499;136525461;130907843;5617618;8;19;397;2241;2430;Baja
Zonas Secundarias;Santa Marta;2023;sep;253725649;104135441;149590208;75232386;74357822;8;19;381;1976;2430;Media
Zonas Secundarias;Santa Marta;2023;oct;248894186;161130317;87763869;128682501;-40918632;8;19;343;2083;2110;Perdida
Zonas Secundarias;Santa Marta;2023;nov;251727245;139524786;112202459;102326458;9876001;7;19;395;1752;2110;Baja
Zonas Secundarias;Santa Marta;2023;dic;253960197;121732935;132227262;94206461;38020801;8;19;446;1620;2110;Baja
Zonas Secundarias;Santa Marta;2024;ene;288974097;151000759;137973338;102877433;35095905;8;19;425;2039;2110;Baja
Zonas Secundarias;Santa Marta;2024;feb;186590980;128810972;57780008;116577894;-58797886;8;18;295;1208;2110;Perdida
Zonas Secundarias;Santa Marta;2024;mar;224275442;140204251;84071191;98019381;-13948190;7;18;327;1492;2110;Perdida
Zonas Secundarias;Santa Marta;2024;abr;293717412;151908910;141808502;127950940;13857562;7;18;373;1926;2110;Baja
Zonas Secundarias;Santa Marta;2024;may;272147622;146867548;125280074;103183714;22096360;7;18;405;1687;2110;Baja
Zonas Secundarias;Santa Marta;2024;jun;246804933;133385678;113419255;103187628;10231627;7;17;321;1788;1950;Baja
Zonas Secundarias;Santa Marta;2024;jul;250883960;150252681;100631279;111440221;-10808942;7;17;347;1723;1910;Perdida
Zonas Secundarias;Santa Marta;2024;ago;265569440;150890590;114678850;113718041;960809;7;17;358;1941;1910;Perdida
Zonas Secundarias;Santa Marta;2024;sep;256460164;145458791;111001373;102609298;8392075;9;18;315;1877;1910;Baja
Zonas Secundarias;Santa Marta;2024;oct;251373990;120014399;131359591;96473130;34886461;8;17;309;1909;1910;Baja
Zonas Secundarias;Santa Marta;2024;nov;273189937;133040563;140149374;107123786;33025588;6;19;315;2047;2110;Baja
Zonas Secundarias;Santa Marta;2024;dic;279093722;158336688;120757034;119697051;1059983;6;19;345;1716;2110;Perdida
Zonas Secundarias;Sincelejo;2021;ene;0;0;0;436727;-436727;0;0;0;0;0;Perdida
Zonas Secundarias;Sincelejo;2021;feb;0;0;0;3139779;-3139779;0;0;0;0;0;Perdida
Zonas Secundarias;Sincelejo;2021;mar;1160510;54316;1106194;530704;575490;0;0;8;11;0;Alta
Zonas Secundarias;Sincelejo;2021;abr;5939803;314316;5625487;291881;5333606;0;0;36;53;0;Alta
Zonas Secundarias;Sincelejo;2021;may;3482528;133291;3349237;86951;3262286;0;0;22;31;0;Alta
Zonas Secundarias;Sincelejo;2021;jun;6987707;393291;6594416;293691;6300725;0;0;43;58;0;Alta
Zonas Secundarias;Sincelejo;2021;jul;5278135;133291;5144844;295524;4849320;0;0;36;45;0;Alta
Zonas Secundarias;Sincelejo;2021;ago;6763322;133291;6630031;314501;6315530;0;0;41;60;0;Alta
Zonas Secundarias;Sincelejo;2021;sep;7364834;133291;7231543;3470146;3761397;0;0;47;66;0;Alta
Zonas Secundarias;Sincelejo;2021;oct;8864032;157125;8706907;460561;8246346;0;0;55;80;0;Alta
Zonas Secundarias;Sincelejo;2021;nov;8615130;157125;8458005;403296;8054709;0;0;54;76;0;Alta
Zonas Secundarias;Sincelejo;2021;dic;7351145;471724;6879421;714079;6165342;0;0;45;62;0;Alta
Zonas Secundarias;Sincelejo;2022;ene;13360937;3818228;9542709;191981;9350728;0;0;52;76;0;Alta
Zonas Secundarias;Sincelejo;2022;feb;11875765;2688629;9187136;317871;8869265;0;0;40;63;0;Alta
Zonas Secundarias;Sincelejo;2022;mar;17168095;4411247;12756848;26140269;-13383421;0;0;55;85;0;Perdida
Zonas Secundarias;Sincelejo;2022;abr;17461863;4861936;12599927;23602285;-11002358;1;0;63;86;0;Perdida
Zonas Secundarias;Sincelejo;2022;may;13526387;2800631;10725756;52089508;-41363752;1;0;42;78;0;Perdida
Zonas Secundarias;Sincelejo;2022;jun;15312255;3662695;11649560;105605617;-93956057;1;0;52;82;0;Perdida
Zonas Secundarias;Sincelejo;2022;jul;20196471;6756728;13439743;32187974;-18748231;2;0;67;109;160;Perdida
Zonas Secundarias;Sincelejo;2022;ago;23031654;8258339;14773315;25165961;-10392646;2;0;74;129;160;Perdida
Zonas Secundarias;Sincelejo;2022;sep;23389434;8141163;15248271;35167350;-19919079;2;0;70;134;160;Perdida
Zonas Secundarias;Sincelejo;2022;oct;22360078;11280301;11079777;30323948;-19244171;3;0;67;118;160;Perdida
Zonas Secundarias;Sincelejo;2022;nov;18825461;11305697;7519764;86958140;-79438376;2;1;59;99;160;Perdida
Zonas Secundarias;Sincelejo;2022;dic;26991754;12717980;14273774;30193970;-15920196;3;0;81;147;160;Perdida
Zonas Secundarias;Sincelejo;2023;ene;25499269;13174774;12324495;28330945;-16006450;3;0;78;129;160;Perdida
Zonas Secundarias;Sincelejo;2023;feb;25888018;11960708;13927310;27854341;-13927031;3;0;72;132;160;Perdida
Zonas Secundarias;Sincelejo;2023;mar;27504688;15672809;11831879;21423361;-9591482;3;0;67;135;160;Perdida
Zonas Secundarias;Sincelejo;2023;abr;19781022;12771018;7010004;23947404;-16937400;3;0;57;104;160;Perdida
Zonas Secundarias;Sincelejo;2023;may;29382341;19449753;9932588;36930865;-26998277;3;0;72;139;160;Perdida
Zonas Secundarias;Sincelejo;2023;jun;28961508;21511015;7450493;27729850;-20279357;4;0;68;120;320;Perdida
Zonas Secundarias;Sincelejo;2023;jul;29138998;19666268;9472730;17471831;-7999101;4;0;80;140;320;Perdida
Zonas Secundarias;Sincelejo;2023;ago;27119424;20033427;7085997;50510959;-43424962;4;0;76;132;320;Perdida
Zonas Secundarias;Sincelejo;2023;sep;23521828;16402167;7119661;13913263;-6793602;4;0;70;127;320;Perdida
Zonas Secundarias;Sincelejo;2023;oct;34376455;23715610;10660845;6320189;4340656;1;3;81;156;320;Baja
Zonas Secundarias;Sincelejo;2023;nov;34773547;22170738;12602809;21571515;-8968706;1;3;84;178;320;Perdida
Zonas Secundarias;Sincelejo;2023;dic;33380205;18305972;15074233;37635253;-22561020;1;3;64;133;320;Perdida
Zonas Secundarias;Sincelejo;2024;ene;29439732;20833195;8606537;23281029;-14674492;1;3;72;124;320;Perdida
Zonas Secundarias;Sincelejo;2024;feb;40657794;27398645;13259149;26512545;-13253396;1;3;89;151;320;Perdida
Zonas Secundarias;Sincelejo;2024;mar;30637120;21210568;9426552;21604054;-12177502;0;3;73;157;320;Perdida
Zonas Secundarias;Sincelejo;2024;abr;42974244;28712176;14262068;17528920;-3266852;0;4;109;180;520;Perdida
Zonas Secundarias;Sincelejo;2024;may;43667256;32547142;11120114;19170721;-8050607;0;4;89;232;520;Perdida
Zonas Secundarias;Sincelejo;2024;jun;51955846;26830108;25125738;25283931;-158193;0;4;97;317;520;Perdida
Zonas Secundarias;Sincelejo;2024;jul;42517714;41386015;1131699;33184637;-32052938;1;5;103;188;680;Perdida
Zonas Secundarias;Sincelejo;2024;ago;50055499;32012408;18043091;22416564;-4373473;1;5;111;265;680;Perdida
Zonas Secundarias;Sincelejo;2024;sep;52026062;46100838;5925224;31071451;-25146227;1;5;106;279;680;Perdida
Zonas Secundarias;Sincelejo;2024;oct;60868115;36418280;24449835;29800303;-5350468;1;5;118;411;680;Perdida
Zonas Secundarias;Sincelejo;2024;nov;54325918;32159396;22166522;23138496;-971974;1;5;107;269;680;Perdida
Zonas Secundarias;Sincelejo;2024;dic;52499037;45197097;7301940;27830841;-20528901;1;5;103;368;680;Perdida
Zonas Secundarias;Valledupar TASA Taller;2021;ene;133247573;60187921;73059652;66271923;6787729;5;10;219;1288;1520;Baja
Zonas Secundarias;Valledupar TASA Taller;2021;feb;153848139;76165695;77682444;89336962;-11654518;5;10;185;1287;1520;Perdida
Zonas Secundarias;Valledupar TASA Taller;2021;mar;119602270;68724642;50877628;77101735;-26224107;6;11;195;1134;1680;Perdida
Zonas Secundarias;Valledupar TASA Taller;2021;abr;151208250;62280512;88927738;72513743;16413995;6;10;195;1414;1520;Baja
Zonas Secundarias;Valledupar TASA Taller;2021;may;170866480;81791453;89075027;82710474;6364553;6;13;221;1689;1840;Baja
Zonas Secundarias;Valledupar TASA Taller;2021;jun;174236912;92183492;82053420;81265475;787945;6;13;247;1586;1840;Perdida
Zonas Secundarias;Valledupar TASA Taller;2021;jul;176708463;78018552;98689911;90659525;8030386;6;13;253;1354;1840;Baja
Zonas Secundarias;Valledupar TASA Taller;2021;ago;193635967;91538891;102097076;78464028;23633048;6;14;253;1700;2040;Baja
Zonas Secundarias;Valledupar TASA Taller;2021;sep;178022922;81789476;96233446;93360793;2872653;5;15;251;1604;2200;Baja
Zonas Secundarias;Valledupar TASA Taller;2021;oct;166917782;87505219;79412563;71295737;8116826;5;15;210;1469;2200;Baja
Zonas Secundarias;Valledupar TASA Taller;2021;nov;136799603;87512411;49287192;72494816;-23207624;5;15;187;1103;2360;Perdida
Zonas Secundarias;Valledupar TASA Taller;2021;dic;247124231;125353925;121770306;87436597;34333709;5;15;231;1631;2360;Baja
Zonas Secundarias;Valledupar TASA Taller;2022;ene;147288573;83177827;64110746;58183899;5926847;5;15;196;1284;2360;Baja
Zonas Secundarias;Valledupar TASA Taller;2022;feb;157336062;84540202;72795860;85690791;-12894931;5;15;197;1244;2360;Perdida
Zonas Secundarias;Valledupar TASA Taller;2022;mar;162707102;85524348;77182754;90778054;-13595300;5;15;246;1387;2360;Perdida
Zonas Secundarias;Valledupar TASA Taller;2022;abr;142299338;83286299;59013039;93538806;-34525767;5;15;218;1211;2360;Perdida
Zonas Secundarias;Valledupar TASA Taller;2022;may;167657342;88177106;79480236;89764612;-10284376;5;15;249;1441;2360;Perdida
Zonas Secundarias;Valledupar TASA Taller;2022;jun;190782615;97067194;93715421;72958615;20756806;5;15;237;1467;2360;Baja
Zonas Secundarias;Valledupar TASA Taller;2022;jul;191275806;97606083;93669723;73869415;19800308;5;16;219;1334;2520;Baja
Zonas Secundarias;Valledupar TASA Taller;2022;ago;212043742;107763652;104280090;67670337;36609753;5;17;257;1677;2520;Baja
Zonas Secundarias;Valledupar TASA Taller;2022;sep;144378745;102714511;41664234;89189297;-47525063;5;16;228;1087;2360;Perdida
Zonas Secundarias;Valledupar TASA Taller;2022;oct;194038407;84461339;109577068;80523598;29053470;5;16;205;1483;2360;Baja
Zonas Secundarias;Valledupar TASA Taller;2022;nov;165586407;86068452;79517955;102166712;-22648757;6;15;211;1426;2360;Perdida
Zonas Secundarias;Valledupar TASA Taller;2022;dic;189635779;79566975;110068804;73382447;36686357;5;16;244;1372;2200;Baja
Zonas Secundarias;Valledupar TASA Taller;2023;ene;143552972;108590015;34962957;75243535;-40280578;5;16;202;1181;2200;Perdida
Zonas Secundarias;Valledupar TASA Taller;2023;feb;153687764;70330149;83357615;74997506;8360109;5;15;199;1157;2200;Baja
Zonas Secundarias;Valledupar TASA Taller;2023;mar;190284627;86504116;103780511;165699925;-61919414;5;15;233;1483;2200;Perdida
Zonas Secundarias;Valledupar TASA Taller;2023;abr;182512617;98150467;84362150;62410420;21951730;4;15;232;1498;2200;Baja
Zonas Secundarias;Valledupar TASA Taller;2023;may;192028767;135510372;56518395;65527217;-9008822;5;15;214;1319;2200;Perdida
Zonas Secundarias;Valledupar TASA Taller;2023;jun;204018311;107965223;96053088;80309881;15743207;5;15;215;1270;2200;Baja
Zonas Secundarias;Valledupar TASA Taller;2023;jul;190149452;97084850;93064602;75676427;17388175;5;15;201;1270;2200;Baja
Zonas Secundarias;Valledupar TASA Taller;2023;ago;156017066;109906418;46110648;82174727;-36064079;5;15;199;1256;2200;Perdida
Zonas Secundarias;Valledupar TASA Taller;2023;sep;146361963;71901817;74460146;83551197;-9091051;5;14;181;1056;2000;Perdida
Zonas Secundarias;Valledupar TASA Taller;2023;oct;195068588;133832626;61235962;74996552;-13760590;5;14;215;1387;2000;Perdida
Zonas Secundarias;Valledupar TASA Taller;2023;nov;172007788;84110186;87897602;69548193;18349409;5;14;214;1147;2000;Baja
Zonas Secundarias;Valledupar TASA Taller;2023;dic;168897039;88532385;80364654;80500530;-135876;5;14;224;1047;2000;Perdida
Zonas Secundarias;Valledupar TASA Taller;2024;ene;175679469;98154032;77525437;73789047;3736390;4;14;216;1122;2000;Baja
Zonas Secundarias;Valledupar TASA Taller;2024;feb;207990717;119385487;88605230;93953780;-5348550;5;13;187;1465;2000;Perdida
Zonas Secundarias;Valledupar TASA Taller;2024;mar;161447970;103530507;57917463;88916573;-30999110;5;13;205;1337;2000;Perdida
Zonas Secundarias;Valledupar TASA Taller;2024;abr;186851691;104747866;82103825;88647700;-6543875;5;14;230;1265;1840;Perdida
Zonas Secundarias;Valledupar TASA Taller;2024;may;116525986;93480072;23045914;86729337;-63683423;5;15;165;621;2000;Perdida
Zonas Secundarias;Valledupar TASA Taller;2024;jun;143780244;87846845;55933399;75549137;-19615738;5;17;182;771;2200;Perdida
Zonas Secundarias;Valledupar TASA Taller;2024;jul;210633857;122054766;88579091;80175749;8403342;5;17;207;1426;2200;Baja
Zonas Secundarias;Valledupar TASA Taller;2024;ago;207807089;127838313;79968776;91141301;-11172525;5;17;210;1241;2200;Perdida
Zonas Secundarias;Valledupar TASA Taller;2024;sep;231624514;111790779;119833735;85479509;34354226;5;14;278;1455;2000;Baja
Zonas Secundarias;Valledupar TASA Taller;2024;oct;184728242;76648741;108079501;74807850;33271651;5;13;212;1175;2000;Baja
Zonas Secundarias;Valledupar TASA Taller;2024;nov;196372547;105292348;91080199;94549967;-3469768;5;14;215;1139;2000;Perdida
Zonas Secundarias;Valledupar TASA Taller;2024;dic;215044272;98520530;116523742;129566040;-13042298;5;15;237;1336;2000;Perdida
Zonas Secundarias;Cali- 3 Norte;2021;ene;208985488;105888966;103096522;121962039;-18865517;8;10;454;1167;1690;Perdida
Zonas Secundarias;Cali- 3 Norte;2021;feb;275350423;127957078;147393345;143062539;4330806;8;10;572;1510;1690;Baja
Zonas Secundarias;Cali- 3 Norte;2021;mar;276140688;141859980;134280708;147307918;-13027210;8;11;622;1479;1690;Perdida
Zonas Secundarias;Cali- 3 Norte;2021;abr;198164391;144203557;53960834;41501011;12459823;8;11;413;1060;1690;Baja
Zonas Secundarias;Cali- 3 Norte;2021;may;97606093;73606994;23999099;80252304;-56253205;8;11;185;572;1690;Perdida
Zonas Secundarias;Cali- 3 Norte;2021;jun;225707359;118226414;107480945;94814130;12666815;8;11;489;1236;1690;Baja
Zonas Secundarias;Cali- 3 Norte;2021;jul;307367566;141657754;165709812;86253123;79456689;8;12;600;1464;1850;Media
Zonas Secundarias;Cali- 3 Norte;2021;ago;328207807;153453717;174754090;98506272;76247818;8;12;607;1667;1850;Media
Zonas Secundarias;Cali- 3 Norte;2021;sep;319606032;151608369;167997663;104557031;63440632;9;12;608;1692;1850;Baja
Zonas Secundarias;Cali- 3 Norte;2021;oct;344299717;145995025;198304692;101519649;96785043;9;12;677;1722;1850;Media
Zonas Secundarias;Cali- 3 Norte;2021;nov;305418810;126479177;178939633;98646706;80292927;9;11;627;1548;1600;Media
Zonas Secundarias;Cali- 3 Norte;2021;dic;333666633;143086318;190580315;110501573;80078742;8;10;670;1638;1600;Media
Zonas Secundarias;Cali- 3 Norte;2022;ene;296057103;131385476;164671627;121400958;43270669;8;10;588;1513;1600;Baja
Zonas Secundarias;Cali- 3 Norte;2022;feb;282890927;123375682;159515245;134793514;24721731;8;10;603;1450;1600;Baja
Zonas Secundarias;Cali- 3 Norte;2022;mar;326121881;147291501;178830380;139184464;39645916;8;10;627;1515;1600;Baja
Zonas Secundarias;Cali- 3 Norte;2022;abr;347666742;160075441;187591301;135939121;51652180;9;10;618;1644;1600;Baja
Zonas Secundarias;Cali- 3 Norte;2022;may;318600356;159436174;159164182;147786920;11377262;9;10;603;1415;1600;Baja
Zonas Secundarias;Cali- 3 Norte;2022;jun;330928142;157330976;173597166;124120732;49476434;9;10;594;1514;1600;Baja
Zonas Secundarias;Cali- 3 Norte;2022;jul;337499079;167387376;170111703;73326955;96784748;7;11;605;1453;1600;Media
Zonas Secundarias;Cali- 3 Norte;2022;ago;375623503;190901613;184721890;101556990;83164900;7;11;625;1706;1600;Media
Zonas Secundarias;Cali- 3 Norte;2022;sep;347204956;166054286;181150670;80358293;100792377;7;12;588;1596;1600;Media
Zonas Secundarias;Cali- 3 Norte;2022;oct;316281536;153620754;162660782;86895912;75764870;7;12;555;1472;1600;Media
Zonas Secundarias;Cali- 3 Norte;2022;nov;335295607;129070593;206225014;84437991;121787023;8;10;562;1530;1600;Media
Zonas Secundarias;Cali- 3 Norte;2022;dic;362601975;186132826;176469149;103927491;72541658;7;11;648;1608;1600;Baja
Zonas Secundarias;Cali- 3 Norte;2023;ene;340823343;156449804;184373539;140330274;44043265;7;11;591;1455;1600;Baja
Zonas Secundarias;Cali- 3 Norte;2023;feb;334649705;159200200;175449505;136562710;38886795;7;11;526;1437;1600;Baja
Zonas Secundarias;Cali- 3 Norte;2023;mar;415814781;172876658;242938123;155042096;87896027;8;11;587;1746;1600;Baja
Zonas Secundarias;Cali- 3 Norte;2023;abr;305867609;155807230;150060379;142304331;7756048;9;10;482;1205;1440;Baja
Zonas Secundarias;Cali- 3 Norte;2023;may;317278588;185160290;132118298;99729465;32388833;9;10;481;1297;1440;Baja
Zonas Secundarias;Cali- 3 Norte;2023;jun;301749925;141144905;160605020;110065620;50539400;10;11;449;1288;1600;Baja
Zonas Secundarias;Cali- 3 Norte;2023;jul;275534882;132827374;142707508;118506297;24201211;10;11;468;1104;1600;Baja
Zonas Secundarias;Cali- 3 Norte;2023;ago;322675101;155665183;167009918;126822299;40187619;10;11;511;1322;1600;Baja
Zonas Secundarias;Cali- 3 Norte;2023;sep;246919178;122883434;124035744;102949413;21086331;10;12;435;1030;1760;Baja
Zonas Secundarias;Cali- 3 Norte;2023;oct;258967227;122300719;136666508;118945637;17720871;9;10;463;1080;1440;Baja
Zonas Secundarias;Cali- 3 Norte;2023;nov;313500359;137905080;175595279;120426219;55169060;9;9;474;1242;1280;Baja
Zonas Secundarias;Cali- 3 Norte;2023;dic;464552094;140952942;323599152;92534982;231064170;8;9;457;1179;1280;Alta
Zonas Secundarias;Cali- 3 Norte;2024;ene;326952360;147312522;179639838;186196862;-6557024;8;10;512;1151;1440;Perdida
Zonas Secundarias;Cali- 3 Norte;2024;feb;292658790;136730674;155928116;64545026;91383090;8;10;475;983;1440;Media
Zonas Secundarias;Cali- 3 Norte;2024;mar;255668262;130899963;124768299;87768477;36999822;8;10;425;917;1440;Baja
Zonas Secundarias;Cali- 3 Norte;2024;abr;329564487;134582317;194982170;98404925;96577245;8;9;467;1156;1280;Media
Zonas Secundarias;Cali- 3 Norte;2024;may;287362508;137914400;149448108;102398729;47049379;7;9;443;1057;1280;Baja
Zonas Secundarias;Cali- 3 Norte;2024;jun;262283298;189500593;72782705;111559685;-38776980;7;9;404;914;1280;Perdida
Zonas Secundarias;Cali- 3 Norte;2024;jul;299578629;116144654;183433975;78566009;104867966;7;9;507;1014;1280;Media
Zonas Secundarias;Cali- 3 Norte;2024;ago;284631686;129364466;155267220;115480270;39786950;8;9;471;979;1280;Baja
Zonas Secundarias;Cali- 3 Norte;2024;sep;267328305;122379603;144948702;141246920;3701782;8;10;434;873;1440;Baja
Zonas Secundarias;Cali- 3 Norte;2024;oct;339840534;139631287;200209247;138994446;61214801;8;9;504;1147;1440;Baja
Zonas Secundarias;Cali- 3 Norte;2024;nov;258849898;115256046;143593852;92645805;50948047;8;9;420;895;1280;Baja
Zonas Secundarias;Cali- 3 Norte;2024;dic;419698417;131265390;288433027;105080842;183352185;8;8;482;1038;1120;Alta
Zonas Secundarias;Cali Paso Ancho;2021;ene;198452783;92306482;106146301;73940729;32205572;7;10;511;948;1530;Baja
Zonas Secundarias;Cali Paso Ancho;2021;feb;234061060;92173975;141887085;81088998;60798087;7;11;569;1178;1690;Media
Zonas Secundarias;Cali Paso Ancho;2021;mar;292572979;117125399;175447580;88714342;86733238;8;12;670;1318;1850;Media
Zonas Secundarias;Cali Paso Ancho;2021;abr;186301752;82817532;103484220;82733718;20750502;8;12;462;867;1690;Baja
Zonas Secundarias;Cali Paso Ancho;2021;may;132123753;74267362;57856391;76453845;-18597454;8;12;346;602;1690;Perdida
Zonas Secundarias;Cali Paso Ancho;2021;jun;258829770;111868311;146961459;88059566;58901893;8;12;626;1261;1690;Media
Zonas Secundarias;Cali Paso Ancho;2021;jul;224548623;113315774;111232849;96435889;14796960;8;13;630;1138;1850;Baja
Zonas Secundarias;Cali Paso Ancho;2021;ago;249034848;115646344;133388504;87447434;45941070;8;13;651;1255;1850;Baja
Zonas Secundarias;Cali Paso Ancho;2021;sep;251120381;115248005;135872376;84594271;51278105;9;13;687;1296;1850;Baja
Zonas Secundarias;Cali Paso Ancho;2021;oct;244441539;114106560;130334979;104408061;25926918;8;13;666;1266;2010;Baja
Zonas Secundarias;Cali Paso Ancho;2021;nov;278121888;123383815;154738073;108525063;46213010;8;12;690;1397;1850;Baja
Zonas Secundarias;Cali Paso Ancho;2021;dic;303263873;118965143;184298730;129389370;54909360;9;12;723;1467;1850;Baja
Zonas Secundarias;Cali Paso Ancho;2022;ene;256392396;144209551;112182845;87595709;24587136;9;12;599;1256;1850;Baja
Zonas Secundarias;Cali Paso Ancho;2022;feb;297715423;125380321;172335102;102090894;70244208;11;13;659;1430;2010;Media
Zonas Secundarias;Cali Paso Ancho;2022;mar;328450992;136841676;191609316;120635432;70973884;11;11;690;1549;1850;Baja
Zonas Secundarias;Cali Paso Ancho;2022;abr;298686974;123435093;175251881;114952974;60298907;10;11;675;1409;1850;Baja
Zonas Secundarias;Cali Paso Ancho;2022;may;299483224;149958244;149524980;113599730;35925250;10;12;672;1445;1850;Baja
Zonas Secundarias;Cali Paso Ancho;2022;jun;269778860;122702637;147076223;112515080;34561143;10;12;633;1168;1850;Baja
Zonas Secundarias;Cali Paso Ancho;2022;jul;296221574;143028457;153193117;127955780;25237337;9;14;646;1269;2330;Baja
Zonas Secundarias;Cali Paso Ancho;2022;ago;327334094;146916692;180417402;106107632;74309770;10;14;709;1507;2170;Media
Zonas Secundarias;Cali Paso Ancho;2022;sep;335090837;150659589;184431248;142757856;41673392;10;15;700;1506;2170;Baja
Zonas Secundarias;Cali Paso Ancho;2022;oct;314823500;142540083;172283417;121207215;51076202;10;15;683;1393;2170;Baja
Zonas Secundarias;Cali Paso Ancho;2022;nov;304669557;132753979;171915578;116902420;55013158;13;11;645;1389;1850;Baja
Zonas Secundarias;Cali Paso Ancho;2022;dic;346972016;147861900;199110116;137256908;61853208;9;15;755;1610;2010;Baja
Zonas Secundarias;Cali Paso Ancho;2023;ene;341397706;150690953;190706753;89474435;101232318;10;13;730;1467;1850;Media
Zonas Secundarias;Cali Paso Ancho;2023;feb;349774218;142598920;207175298;120179227;86996071;10;12;702;1527;1690;Media
Zonas Secundarias;Cali Paso Ancho;2023;mar;406639258;168050799;238588459;112119539;126468920;9;12;737;1709;1690;Media
Zonas Secundarias;Cali Paso Ancho;2023;abr;359261081;159183805;200077276;102867084;97210192;9;11;639;1433;1690;Media
Zonas Secundarias;Cali Paso Ancho;2023;may;366151832;159981754;206170078;106201355;99968723;9;11;688;1505;1690;Media
Zonas Secundarias;Cali Paso Ancho;2023;jun;357484496;166229488;191255008;121011464;70243544;10;13;689;1367;2010;Baja
Zonas Secundarias;Cali Paso Ancho;2023;jul;366738220;171553935;195184285;145585379;49598906;12;12;680;1480;1850;Baja
Zonas Secundarias;Cali Paso Ancho;2023;ago;381431965;175143977;206287988;138492836;67795152;12;13;705;1582;2010;Baja
Zonas Secundarias;Cali Paso Ancho;2023;sep;367600087;141345334;226254753;95876667;130378086;10;12;707;1551;1850;Media
Zonas Secundarias;Cali Paso Ancho;2023;oct;366511373;193049201;173462172;133211135;40251037;10;13;686;1478;1920;Baja
Zonas Secundarias;Cali Paso Ancho;2023;nov;324267353;153631488;170635865;116103229;54532636;10;13;656;1346;1920;Baja
Zonas Secundarias;Cali Paso Ancho;2023;dic;276588384;194027018;82561366;130066672;-47505306;11;12;762;1508;1760;Perdida
Zonas Secundarias;Cali Paso Ancho;2024;ene;378097591;166505428;211592163;100886370;110705793;10;13;723;1410;2010;Media
Zonas Secundarias;Cali Paso Ancho;2024;feb;357808491;160885858;196922633;120402825;76519808;11;13;688;1299;2010;Baja
Zonas Secundarias;Cali Paso Ancho;2024;mar;311912545;156151690;155760855;113245524;42515331;11;13;622;1253;2010;Baja
Zonas Secundarias;Cali Paso Ancho;2024;abr;422943031;246414326;176528705;119912085;56616620;12;13;795;1564;2010;Baja
Zonas Secundarias;Cali Paso Ancho;2024;may;379394152;173452988;205941164;135730582;70210582;12;12;657;1515;1850;Baja
Zonas Secundarias;Cali Paso Ancho;2024;jun;299221364;131505332;167716032;109587835;58128197;12;11;576;1013;1690;Baja
Zonas Secundarias;Cali Paso Ancho;2024;jul;360936508;168284494;192652014;133683122;58968892;12;10;678;1233;1530;Baja
Zonas Secundarias;Cali Paso Ancho;2024;ago;311325665;141950959;169374706;123986656;45388050;12;10;604;1070;1530;Baja
Zonas Secundarias;Cali Paso Ancho;2024;sep;336398362;157496008;178902354;120265107;58637247;11;10;655;1155;1530;Baja
Zonas Secundarias;Cali Paso Ancho;2024;oct;357444516;152459647;204984869;94374039;110610830;10;12;673;1224;1690;Media
Zonas Secundarias;Cali Paso Ancho;2024;nov;317734530;137789059;179945471;117121660;62823811;11;14;577;1128;1690;Baja
Zonas Secundarias;Cali Paso Ancho;2024;dic;372139964;147035220;225104744;128132287;96972457;11;15;683;1331;1850;Media
Zonas Secundarias;Cali Sameco;2021;ene;572705364;299825363;272880001;237916081;34963920;26;48;804;5132;6680;Baja
Zonas Secundarias;Cali Sameco;2021;feb;752525335;379266848;373258487;257238683;116019804;27;48;1017;6585;6680;Baja
Zonas Secundarias;Cali Sameco;2021;mar;787784173;385614605;402169568;261768647;140400921;26;49;1247;6888;6610;Baja
Zonas Secundarias;Cali Sameco;2021;abr;578861784;348529037;230332747;222245083;8087664;26;49;903;5206;6610;Baja
Zonas Secundarias;Cali Sameco;2021;may;312340647;288265881;24074766;253299498;-229224732;26;49;429;2738;6610;Perdida
Zonas Secundarias;Cali Sameco;2021;jun;641301486;354154587;287146899;253494825;33652074;26;49;908;5466;6610;Baja
Zonas Secundarias;Cali Sameco;2021;jul;641775038;384418886;257356152;258628657;-1272505;24;49;1076;5620;6610;Perdida
Zonas Secundarias;Cali Sameco;2021;ago;731227983;402111133;329116850;297412583;31704267;25;49;1074;6542;6610;Baja
Zonas Secundarias;Cali Sameco;2021;sep;843158987;470964185;372194802;267928676;104266126;24;51;1335;7352;6930;Baja
Zonas Secundarias;Cali Sameco;2021;oct;879161969;451617812;427544157;259596491;167947666;25;52;1241;7912;7250;Baja
Zonas Secundarias;Cali Sameco;2021;nov;816752251;445841357;370910894;282205024;88705870;25;54;1124;7305;7410;Baja
Zonas Secundarias;Cali Sameco;2021;dic;778017586;450158335;327859251;260559747;67299504;26;55;1121;7182;7410;Baja
Zonas Secundarias;Cali Sameco;2022;ene;717712610;403979971;313732639;269995008;43737631;27;52;898;6559;7090;Baja
Zonas Secundarias;Cali Sameco;2022;feb;878391966;448017216;430374750;307439216;122935534;28;52;964;8360;7090;Baja
Zonas Secundarias;Cali Sameco;2022;mar;789306170;458476904;330829266;337633182;-6803916;27;52;986;7588;7130;Perdida
Zonas Secundarias;Cali Sameco;2022;abr;843278576;458773263;384505313;316740088;67765225;29;51;940;7359;7130;Baja
Zonas Secundarias;Cali Sameco;2022;may;882955294;488926902;394028392;339540273;54488119;29;53;994;7520;7130;Baja
Zonas Secundarias;Cali Sameco;2022;jun;801247612;409274005;391973607;288104156;103869451;29;53;965;6804;7130;Baja
Zonas Secundarias;Cali Sameco;2022;jul;709744819;505977782;203767037;304189275;-100422238;30;51;959;5587;6730;Perdida
Zonas Secundarias;Cali Sameco;2022;ago;801595596;375659510;425936086;309460495;116475591;29;52;952;6756;6730;Baja
Zonas Secundarias;Cali Sameco;2022;sep;742396868;539680950;202715918;277915781;-75199863;28;48;851;6288;6210;Perdida
Zonas Secundarias;Cali Sameco;2022;oct;644846261;381141021;263705240;293065885;-29360645;29;48;831;5585;6210;Perdida
Zonas Secundarias;Cali Sameco;2022;nov;730755691;388280217;342475474;283044952;59430522;35;46;828;6081;7850;Baja
Zonas Secundarias;Cali Sameco;2022;dic;753049878;495904441;257145437;306976735;-49831298;30;49;893;6058;6530;Perdida
Zonas Secundarias;Cali Sameco;2023;ene;816504277;368266616;448237661;314454393;133783268;30;50;807;7095;6930;Baja
Zonas Secundarias;Cali Sameco;2023;feb;698342450;438390749;259951701;309936723;-49985022;30;50;746;5938;6930;Perdida
Zonas Secundarias;Cali Sameco;2023;mar;681775715;434565780;247209935;318931296;-71721361;29;50;813;5628;6930;Perdida
Zonas Secundarias;Cali Sameco;2023;abr;593606352;388046037;205560315;301154300;-95593985;29;50;652;5018;6930;Perdida
Zonas Secundarias;Cali Sameco;2023;may;690972783;419245441;271727342;411178473;-139451131;28;50;714;5263;6930;Perdida
Zonas Secundarias;Cali Sameco;2023;jun;685638112;432773992;252864120;321653847;-68789727;29;47;727;5077;7130;Perdida
Zonas Secundarias;Cali Sameco;2023;jul;746818303;416986971;329831332;347766170;-17934838;28;46;690;5706;6970;Perdida
Zonas Secundarias;Cali Sameco;2023;ago;776805729;456398958;320406771;319672125;734646;29;45;728;5923;6810;Perdida
Zonas Secundarias;Cali Sameco;2023;sep;841514660;362310119;479204541;276623166;202581375;29;45;859;6152;6810;Media
Zonas Secundarias;Cali Sameco;2023;oct;660910551;381926628;278983923;324571565;-45587642;28;48;745;4585;6650;Perdida
Zonas Secundarias;Cali Sameco;2023;nov;704451004;387020673;317430331;292775709;24654622;28;47;680;5206;6490;Baja
Zonas Secundarias;Cali Sameco;2023;dic;730018214;391420392;338597822;224784411;113813411;28;45;798;4599;6330;Baja
Zonas Secundarias;Cali Sameco;2024;ene;754166235;470392677;283773558;291927241;-8153683;27;47;668;5785;6490;Perdida
Zonas Secundarias;Cali Sameco;2024;feb;844456120;417172561;427283559;320735050;106548509;25;47;743;6258;6330;Baja
Zonas Secundarias;Cali Sameco;2024;mar;795660093;436542088;359118005;276790239;82327766;25;46;722;5569;6130;Baja
Zonas Secundarias;Cali Sameco;2024;abr;947720886;520332794;427388092;232040467;195347625;23;49;836;6395;6450;Baja
Zonas Secundarias;Cali Sameco;2024;may;843691387;468916826;374774561;263335677;111438884;24;50;768;5536;6610;Baja
Zonas Secundarias;Cali Sameco;2024;jun;772997795;401840723;371157072;256089037;115068035;24;50;668;4845;6610;Baja
Zonas Secundarias;Cali Sameco;2024;jul;866541671;484305825;382235846;292100303;90135543;23;48;790;6069;6290;Baja
Zonas Secundarias;Cali Sameco;2024;ago;833005064;472555201;360449863;283543792;76906071;22;47;735;5647;6130;Baja
Zonas Secundarias;Cali Sameco;2024;sep;855286570;449600155;405686415;304747741;100938674;21;48;746;5449;6290;Baja
Zonas Secundarias;Cali Sameco;2024;oct;1109089535;479493372;629596163;290161643;339434520;19;47;835;7394;6610;Media
Zonas Secundarias;Cali Sameco;2024;nov;990715090;395768705;594946385;223207143;371739242;21;49;820;6734;6770;Media
Zonas Secundarias;Cali Sameco;2024;dic;865969605;487008363;378961242;271788293;107172949;21;49;842;4887;6770;Baja
Zonas Secundarias;Cali-CIAT;2021;ene;13319947;14885963;-1566016;833522;-2399538;0;0;0;0;0;Perdida
Zonas Secundarias;Cali-CIAT;2021;feb;46042984;33705300;12337684;1034982;11302702;0;0;0;0;0;Media
Zonas Secundarias;Cali-CIAT;2021;mar;17005156;10778216;6226940;2938975;3287965;0;0;0;0;0;Baja
Zonas Secundarias;Cali-CIAT;2021;abr;8368836;10087008;-1718172;725262;-2443434;0;0;0;0;0;Perdida
Zonas Secundarias;Cali-CIAT;2021;may;0;6483674;-6483674;523061;-7006735;0;0;0;0;0;Perdida
Zonas Secundarias;Cali-CIAT;2021;jun;2299288;7627499;-5328211;1775233;-7103444;0;0;0;0;0;Perdida
Zonas Secundarias;Cali-CIAT;2021;jul;10673265;7282003;3391262;734288;2656974;0;0;0;0;0;Media
Zonas Secundarias;Cali-CIAT;2021;ago;9769548;12049075;-2279527;1181084;-3460611;0;0;0;0;0;Perdida
Zonas Secundarias;Cali-CIAT;2021;sep;34951742;13079659;21872083;4451858;17420225;0;0;0;0;0;Alta
Zonas Secundarias;Cali-CIAT;2021;oct;20497993;11570675;8927318;6382285;2545033;0;0;0;0;0;Baja
Zonas Secundarias;Cali-CIAT;2021;nov;13027650;14241738;-1214088;3395713;-4609801;0;0;0;0;0;Perdida
Zonas Secundarias;Cali-CIAT;2021;dic;4645052;10288433;-5643381;2095503;-7738884;0;0;0;0;0;Perdida
Zonas Secundarias;Cali-CIAT;2022;ene;8651390;9908891;-1257501;1922415;-3179916;0;0;0;0;0;Perdida
Zonas Secundarias;Cali-CIAT;2022;feb;16959862;11772584;5187278;776256;4411022;0;0;0;0;0;Media
Zonas Secundarias;Cali-CIAT;2022;mar;12991528;10947713;2043815;1949560;94255;0;0;0;0;0;Perdida
Zonas Secundarias;Cali-CIAT;2022;abr;13358215;12102428;1255787;2472202;-1216415;0;0;0;0;0;Perdida
Zonas Secundarias;Cali-CIAT;2022;may;10693560;10998343;-304783;2584363;-2889146;0;0;0;0;0;Perdida
Zonas Secundarias;Cali-CIAT;2022;jun;13521314;10406601;3114713;1964168;1150545;0;0;0;0;0;Baja
Zonas Secundarias;Cali-CIAT;2022;jul;20564738;13286205;7278533;3480580;3797953;0;0;0;0;0;Baja
Zonas Secundarias;Cali-CIAT;2022;ago;18618382;12364178;6254204;1885404;4368800;0;0;0;0;0;Media
Zonas Secundarias;Cali-CIAT;2022;sep;13033348;11706096;1327252;1833202;-505950;0;0;0;0;0;Perdida
Zonas Secundarias;Cali-CIAT;2022;oct;24245527;15159634;9085893;857771;8228122;0;0;0;0;0;Media
Zonas Secundarias;Cali-CIAT;2022;nov;20197004;13650744;6546260;946379;5599881;0;0;0;0;0;Media
Zonas Secundarias;Cali-CIAT;2022;dic;32837160;15106583;17730577;2980220;14750357;0;0;0;0;0;Alta
Zonas Secundarias;Cali-CIAT;2023;ene;12263351;10489767;1773584;2181707;-408123;0;0;0;0;0;Perdida
Zonas Secundarias;Cali-CIAT;2023;feb;25200643;18155360;7045283;2050630;4994653;0;0;0;0;0;Baja
Zonas Secundarias;Cali-CIAT;2023;mar;12516499;12130178;386321;3056657;-2670336;0;0;0;0;0;Perdida
Zonas Secundarias;Cali-CIAT;2023;abr;19832348;13932731;5899617;2503670;3395947;0;0;0;0;0;Baja
Zonas Secundarias;Cali-CIAT;2023;may;14626002;13936888;689114;802345;-113231;0;0;0;0;0;Perdida
Zonas Secundarias;Cali-CIAT;2023;jun;23257215;15640258;7616957;4408776;3208181;0;0;0;0;0;Baja
Zonas Secundarias;Cali-CIAT;2023;jul;11968181;14276797;-2308616;2951312;-5259928;0;0;0;0;0;Perdida
Zonas Secundarias;Cali-CIAT;2023;ago;21192803;15345092;5847711;1968169;3879542;0;0;0;0;0;Baja
Zonas Secundarias;Cali-CIAT;2023;sep;17129402;15980007;1149395;3863462;-2714067;0;0;0;0;0;Perdida
Zonas Secundarias;Cali-CIAT;2023;oct;32716091;23158161;9557930;1437097;8120833;0;0;0;0;0;Media
Zonas Secundarias;Cali-CIAT;2023;nov;15530965;20457437;-4926472;2578830;-7505302;0;0;0;0;0;Perdida
Zonas Secundarias;Cali-CIAT;2023;dic;21695863;16635893;5059970;3298842;1761128;0;0;0;0;0;Baja
Zonas Secundarias;Cali-CIAT;2024;ene;10239891;13944554;-3704663;963276;-4667939;0;0;0;0;0;Perdida
Zonas Secundarias;Cali-CIAT;2024;feb;18706913;20209414;-1502501;3763757;-5266258;0;0;0;0;0;Perdida
Zonas Secundarias;Cali-CIAT;2024;mar;12564746;24591904;-12027158;6258383;-18285541;0;0;0;0;0;Perdida
Zonas Secundarias;Cali-CIAT;2024;abr;7836179;14430703;-6594524;4169492;-10764016;0;0;0;0;0;Perdida
Zonas Secundarias;Cali-CIAT;2024;may;15357815;17491161;-2133346;3119774;-5253120;0;0;0;0;0;Perdida
Zonas Secundarias;Cali-CIAT;2024;jun;21094395;22717705;-1623310;2471175;-4094485;0;0;0;0;0;Perdida
Zonas Secundarias;Cali-CIAT;2024;jul;27262122;18184134;9077988;2307306;6770682;0;0;0;0;0;Media
Zonas Secundarias;Cali-CIAT;2024;ago;13676270;13508130;168140;3169838;-3001698;0;0;0;0;0;Perdida
Zonas Secundarias;Cali-CIAT;2024;sep;9281220;16668925;-7387705;543496;-7931201;0;0;0;0;0;Perdida
Zonas Secundarias;Cali-CIAT;2024;oct;8528135;4676143;3851992;988797;2863195;0;0;0;0;0;Media
Zonas Secundarias;Cali-CIAT;2024;nov;9347501;9904378;-556877;810555;-1367432;0;0;0;0;0;Perdida
Zonas Secundarias;Cali-CIAT;2024;dic;13238862;11384995;1853867;3244504;-1390637;0;0;0;0;0;Perdida
Zonas Secundarias;Dipart Tulua;2023;jun;7942505;6015567;1926938;1064682;862256;0;1;36;55;160;Baja
Zonas Secundarias;Dipart Tulua;2023;jul;18764499;8900796;9863703;5910896;3952807;0;1;50;102;160;Baja
Zonas Secundarias;Dipart Tulua;2023;ago;17906083;11155074;6751009;5400068;1350941;0;1;57;99;160;Baja
Zonas Secundarias;Dipart Tulua;2023;sep;15592004;11342858;4249146;2582823;1666323;0;1;42;66;160;Baja
Zonas Secundarias;Dipart Tulua;2023;oct;20695363;12955770;7739593;6082660;1656933;0;1;62;96;160;Baja
Zonas Secundarias;Dipart Tulua;2023;nov;14324415;11974375;2350040;11508136;-9158096;0;1;54;75;160;Perdida
Zonas Secundarias;Dipart Tulua;2023;dic;22663644;15820943;6842701;11243672;-4400971;0;1;72;109;160;Perdida
Zonas Secundarias;Dipart Tulua;2024;ene;20602639;12845622;7757017;4998161;2758856;0;1;61;92;160;Baja
Zonas Secundarias;Dipart Tulua;2024;feb;14460896;11265186;3195710;5224186;-2028476;0;1;47;64;160;Perdida
Zonas Secundarias;Dipart Tulua;2024;mar;14836714;12284789;2551925;5642550;-3090625;0;1;52;62;160;Perdida
Zonas Secundarias;Dipart Tulua;2024;abr;23874616;13874859;9999757;5807167;4192590;0;1;67;104;160;Baja
Zonas Secundarias;Dipart Tulua;2024;may;23283837;17161294;6122543;6819982;-697439;0;2;72;100;320;Perdida
Zonas Secundarias;Dipart Tulua;2024;jun;21880973;17226270;4654703;6847074;-2192371;0;2;58;92;320;Perdida
Zonas Secundarias;Dipart Tulua;2024;jul;16015637;13869915;2145722;4744961;-2599239;0;2;53;72;320;Perdida
Zonas Secundarias;Dipart Tulua;2024;ago;21551898;21435494;116404;1883562;-1767158;0;3;98;126;480;Perdida
Zonas Secundarias;Dipart Tulua;2024;sep;22324749;15621466;6703283;7123297;-420014;0;2;97;110;320;Perdida
Zonas Secundarias;Dipart Tulua;2024;oct;15531386;14801737;729649;3135605;-2405956;0;2;83;83;320;Perdida
Zonas Secundarias;Dipart Tulua;2024;nov;29761297;21251846;8509451;4579317;3930134;0;2;108;139;320;Baja
Zonas Secundarias;Dipart Tulua;2024;dic;24602500;15033892;9568608;3441100;6127508;0;1;115;128;160;Media
Zonas Secundarias;Pasto Colision y Alistamiento;2021;ene;50597598;33068758;17528840;25701828;-8172988;1;5;78;471;680;Perdida
Zonas Secundarias;Pasto Colision y Alistamiento;2021;feb;93689817;21817675;71872142;25524142;46348000;1;5;96;1014;680;Alta
Zonas Secundarias;Pasto Colision y Alistamiento;2021;mar;74470793;26666578;47804215;19602166;28202049;0;5;105;683;680;Media
Zonas Secundarias;Pasto Colision y Alistamiento;2021;abr;63267485;25116058;38151427;28205950;9945477;1;5;97;913;680;Baja
Zonas Secundarias;Pasto Colision y Alistamiento;2021;may;26686076;23620523;3065553;22045613;-18980060;1;5;36;288;680;Perdida
Zonas Secundarias;Pasto Colision y Alistamiento;2021;jun;75729076;42480856;33248220;55026827;-21778607;2;5;88;994;680;Perdida
Zonas Secundarias;Pasto Colision y Alistamiento;2021;jul;58071083;24368693;33702390;18338616;15363774;2;5;86;656;680;Media
Zonas Secundarias;Pasto Colision y Alistamiento;2021;ago;65340345;40113140;25227205;27007914;-1780709;2;5;88;926;680;Perdida
Zonas Secundarias;Pasto Colision y Alistamiento;2021;sep;66263003;30696722;35566281;28400423;7165858;2;5;104;628;680;Baja
Zonas Secundarias;Pasto Colision y Alistamiento;2021;oct;74014593;32450107;41564486;37834029;3730457;3;5;102;759;680;Baja
Zonas Secundarias;Pasto Colision y Alistamiento;2021;nov;75365017;35703924;39661093;39535442;125651;3;5;77;870;680;Perdida
Zonas Secundarias;Pasto Colision y Alistamiento;2021;dic;78191786;28736834;49454952;29341452;20113500;3;5;107;1003;680;Media
Zonas Secundarias;Pasto Colision y Alistamiento;2022;ene;44138836;27812834;16326002;29170174;-12844172;3;5;58;526;680;Perdida
Zonas Secundarias;Pasto Colision y Alistamiento;2022;feb;72175897;30098626;42077271;32428583;9648688;3;5;69;977;680;Baja
Zonas Secundarias;Pasto Colision y Alistamiento;2022;mar;75375884;33238602;42137282;33467797;8669485;3;6;69;909;880;Baja
Zonas Secundarias;Pasto Colision y Alistamiento;2022;abr;101491488;42843339;58648149;31441688;27206461;3;6;71;1330;880;Media
Zonas Secundarias;Pasto Colision y Alistamiento;2022;may;102724018;46538546;56185472;43639594;12545878;3;6;77;1367;880;Baja
Zonas Secundarias;Pasto Colision y Alistamiento;2022;jun;86293805;40088756;46205049;30494369;15710680;3;6;77;1099;880;Baja
Zonas Secundarias;Pasto Colision y Alistamiento;2022;jul;76935908;36953835;39982073;30227932;9754141;3;6;71;868;880;Baja
Zonas Secundarias;Pasto Colision y Alistamiento;2022;ago;96532734;40633514;55899220;33922035;21977185;3;6;80;1171;880;Media
Zonas Secundarias;Pasto Colision y Alistamiento;2022;sep;108885561;48719607;60165954;44256625;15909329;3;6;72;1189;880;Baja
Zonas Secundarias;Pasto Colision y Alistamiento;2022;oct;96379830;47738034;48641796;36132730;12509066;3;6;71;1163;880;Baja
Zonas Secundarias;Pasto Colision y Alistamiento;2022;nov;76147578;38899866;37247712;36670382;577330;3;6;58;783;1040;Perdida
Zonas Secundarias;Pasto Colision y Alistamiento;2022;dic;81513089;35368687;46144402;21943927;24200475;3;6;59;952;880;Media
Zonas Secundarias;Pasto Colision y Alistamiento;2023;ene;33543873;26970569;6573304;34355829;-27782525;3;6;28;427;880;Perdida
Zonas Secundarias;Pasto Colision y Alistamiento;2023;feb;56383942;43336666;13047276;27013805;-13966529;3;6;40;660;880;Perdida
Zonas Secundarias;Pasto Colision y Alistamiento;2023;mar;77918090;54683343;23234747;46431781;-23197034;3;6;63;1073;880;Perdida
Zonas Secundarias;Pasto Colision y Alistamiento;2023;abr;34512708;30889066;3623642;30180852;-26557210;3;6;48;337;880;Perdida
Zonas Secundarias;Pasto Colision y Alistamiento;2023;may;80408889;49500705;30908184;39320550;-8412366;3;6;73;850;880;Perdida
Zonas Secundarias;Pasto Colision y Alistamiento;2023;jun;111106471;50718942;60387529;35358253;25029276;3;6;90;1195;880;Media
Zonas Secundarias;Pasto Colision y Alistamiento;2023;jul;56379691;41790908;14588783;33208369;-18619586;3;6;66;547;880;Perdida
Zonas Secundarias;Pasto Colision y Alistamiento;2023;ago;113169460;53731633;59437827;48639748;10798079;3;6;69;1308;880;Baja
Zonas Secundarias;Pasto Colision y Alistamiento;2023;sep;123097087;28364604;94732483;52240032;42492451;3;6;94;1424;880;Media
Zonas Secundarias;Pasto Colision y Alistamiento;2023;oct;82152665;62216999;19935666;45942118;-26006452;3;6;95;947;880;Perdida
Zonas Secundarias;Pasto Colision y Alistamiento;2023;nov;78076257;48511718;29564539;40974404;-11409865;3;6;66;777;880;Perdida
Zonas Secundarias;Pasto Colision y Alistamiento;2023;dic;58555199;37833086;20722113;46876212;-26154099;3;6;76;765;880;Perdida
Zonas Secundarias;Pasto Colision y Alistamiento;2024;ene;51099127;36935946;14163181;48344599;-34181418;3;6;51;538;880;Perdida
Zonas Secundarias;Pasto Colision y Alistamiento;2024;feb;106131973;48538524;57593449;46986408;10607041;3;6;93;1073;880;Baja
Zonas Secundarias;Pasto Colision y Alistamiento;2024;mar;87686886;51333228;36353658;53693954;-17340296;3;6;75;876;880;Perdida
Zonas Secundarias;Pasto Colision y Alistamiento;2024;abr;62616356;39363814;23252542;46921638;-23669096;3;6;71;648;880;Perdida
Zonas Secundarias;Pasto Colision y Alistamiento;2024;may;70288203;48459602;21828601;47201896;-25373295;3;6;81;870;880;Perdida
Zonas Secundarias;Pasto Colision y Alistamiento;2024;jun;95623718;53888246;41735472;36527759;5207713;2;6;68;1009;880;Baja
Zonas Secundarias;Pasto Colision y Alistamiento;2024;jul;101333995;53964537;47369458;44961549;2407909;2;5;80;895;680;Baja
Zonas Secundarias;Pasto Colision y Alistamiento;2024;ago;82452345;49107078;33345267;43836060;-10490793;2;5;91;888;680;Perdida
Zonas Secundarias;Pasto Colision y Alistamiento;2024;sep;90974294;45021993;45952301;60131120;-14178819;2;5;71;978;680;Perdida
Zonas Secundarias;Pasto Colision y Alistamiento;2024;oct;94448168;35599833;58848335;38119901;20728434;2;5;81;988;680;Baja
Zonas Secundarias;Pasto Colision y Alistamiento;2024;nov;68822589;35918405;32904184;34842153;-1937969;3;6;86;576;880;Perdida
Zonas Secundarias;Pasto Colision y Alistamiento;2024;dic;110013225;58115354;51897871;45855597;6042274;3;6;96;960;880;Baja
Zonas Secundarias;Popayan;2021;ene;32286782;15252378;17034404;28670280;-11635876;3;4;121;189;480;Perdida
Zonas Secundarias;Popayan;2021;feb;41561169;20506334;21054835;28732350;-7677515;3;4;137;224;480;Perdida
Zonas Secundarias;Popayan;2021;mar;47596288;21486656;26109632;35573953;-9464321;3;4;179;268;480;Perdida
Zonas Secundarias;Popayan;2021;abr;40661223;18972548;21688675;32977089;-11288414;3;4;135;226;480;Perdida
Zonas Secundarias;Popayan;2021;may;10015542;11870844;-1855302;28864632;-30719934;3;4;39;56;480;Perdida
Zonas Secundarias;Popayan;2021;jun;30382920;18742162;11640758;31804662;-20163904;3;4;123;174;480;Perdida
Zonas Secundarias;Popayan;2021;jul;40297617;21689505;18608112;32836280;-14228168;3;4;145;215;480;Perdida
Zonas Secundarias;Popayan;2021;ago;46213189;22185423;24027766;34092222;-10064456;3;4;168;249;480;Perdida
Zonas Secundarias;Popayan;2021;sep;42753035;22247260;20505775;32491308;-11985533;3;4;153;227;480;Perdida
Zonas Secundarias;Popayan;2021;oct;48094860;22901449;25193411;17148614;8044797;3;4;166;257;480;Baja
Zonas Secundarias;Popayan;2021;nov;47037903;25684701;21353202;34986590;-13633388;3;5;151;245;730;Perdida
Zonas Secundarias;Popayan;2021;dic;48936545;25893628;23042917;35538111;-12495194;3;5;172;261;730;Perdida
Zonas Secundarias;Popayan;2022;ene;34776174;19666446;15109728;29358883;-14249155;3;4;132;168;730;Perdida
Zonas Secundarias;Popayan;2022;feb;45983137;25415988;20567149;26967216;-6400067;3;4;158;236;730;Perdida
Zonas Secundarias;Popayan;2022;mar;50741956;23176168;27565788;28881878;-1316090;3;4;167;274;730;Perdida
Zonas Secundarias;Popayan;2022;abr;46151110;24396806;21754304;39265437;-17511133;3;4;150;234;730;Perdida
Zonas Secundarias;Popayan;2022;may;50076033;26440313;23635720;31853445;-8217725;3;4;163;247;730;Perdida
Zonas Secundarias;Popayan;2022;jun;42654083;22400772;20253311;36174832;-15921521;3;4;145;230;730;Perdida
Zonas Secundarias;Popayan;2022;jul;42558493;22956216;19602277;29351466;-9749189;2;4;142;221;730;Perdida
Zonas Secundarias;Popayan;2022;ago;58491627;33685994;24805633;40776051;-15970418;2;4;166;307;730;Perdida
Zonas Secundarias;Popayan;2022;sep;50718763;32296425;18422338;50949332;-32526994;2;5;166;253;730;Perdida
Zonas Secundarias;Popayan;2022;oct;45520664;40338333;5182331;30390756;-25208425;2;5;168;218;730;Perdida
Zonas Secundarias;Popayan;2022;nov;46281205;28361813;17919392;31772007;-13852615;3;4;154;249;730;Perdida
Zonas Secundarias;Popayan;2022;dic;48149849;29742680;18407169;23053589;-4646420;2;5;164;225;730;Perdida
Zonas Secundarias;Popayan;2023;ene;44620488;33424211;11196277;33982493;-22786216;2;5;128;215;730;Perdida
Zonas Secundarias;Popayan;2023;feb;54631807;35554006;19077801;34353693;-15275892;2;5;158;265;730;Perdida
Zonas Secundarias;Popayan;2023;mar;49164099;37418309;11745790;34036167;-22290377;2;5;153;236;730;Perdida
Zonas Secundarias;Popayan;2023;abr;56453281;35303355;21149926;38941155;-17791229;3;5;143;268;730;Perdida
Zonas Secundarias;Popayan;2023;may;59781557;40013797;19767760;27114562;-7346802;3;5;162;292;730;Perdida
Zonas Secundarias;Popayan;2023;jun;58209367;40334690;17874677;32888285;-15013608;3;5;168;267;730;Perdida
Zonas Secundarias;Popayan;2023;jul;62745414;45004576;17740838;37415679;-19674841;3;5;149;252;730;Perdida
Zonas Secundarias;Popayan;2023;ago;73745248;48968374;24776874;35445151;-10668277;3;5;180;309;730;Perdida
Zonas Secundarias;Popayan;2023;sep;50826446;35838645;14987801;42561960;-27574159;3;5;133;205;730;Perdida
Zonas Secundarias;Popayan;2023;oct;62598684;32105794;30492890;44136750;-13643860;3;5;167;294;730;Perdida
Zonas Secundarias;Popayan;2023;nov;81422894;34854315;46568579;49995731;-3427152;3;5;138;427;730;Perdida
Zonas Secundarias;Popayan;2023;dic;61794138;31008524;30785614;31165385;-379771;3;5;170;238;730;Perdida
Zonas Secundarias;Popayan;2024;ene;63403226;38427035;24976191;37145138;-12168947;3;5;157;253;730;Perdida
Zonas Secundarias;Popayan;2024;feb;57959790;38062158;19897632;42534721;-22637089;3;5;152;234;730;Perdida
Zonas Secundarias;Popayan;2024;mar;64273825;44701565;19572260;31453433;-11881173;3;5;134;215;730;Perdida
Zonas Secundarias;Popayan;2024;abr;65220719;38764119;26456600;50298845;-23842245;3;4;166;254;730;Perdida
Zonas Secundarias;Popayan;2024;may;50264599;42251386;8013213;35011872;-26998659;3;4;131;175;730;Perdida
Zonas Secundarias;Popayan;2024;jun;62405200;48441095;13964105;61730466;-47766361;3;5;145;226;730;Perdida
Zonas Secundarias;Popayan;2024;jul;77234231;43176574;34057657;27361397;6696260;3;5;178;249;730;Baja
Zonas Secundarias;Popayan;2024;ago;66851600;40894463;25957137;43366531;-17409394;3;5;163;241;730;Perdida
Zonas Secundarias;Popayan;2024;sep;65214648;45705993;19508655;41176914;-21668259;3;5;144;213;730;Perdida
Zonas Secundarias;Popayan;2024;oct;68956950;40347295;28609655;58199600;-29589945;2;5;164;249;730;Perdida
Zonas Secundarias;Popayan;2024;nov;80757658;62320159;18437499;38573002;-20135503;3;5;114;153;730;Perdida
Zonas Secundarias;Popayan;2024;dic;97487294;65432105;32055189;50459026;-18403837;3;4;177;237;730;Perdida
Zonas Secundarias;TASA Pasto;2021;ene;46703731;26227247;20476484;23931358;-3454874;4;5;161;310;750;Perdida
Zonas Secundarias;TASA Pasto;2021;feb;74793570;36608979;38184591;38808677;-624086;5;5;212;489;750;Perdida
Zonas Secundarias;TASA Pasto;2021;mar;81595235;39745838;41849397;31333704;10515693;5;5;251;541;750;Baja
Zonas Secundarias;TASA Pasto;2021;abr;69177631;35439790;33737841;40861277;-7123436;5;5;208;454;750;Perdida
Zonas Secundarias;TASA Pasto;2021;may;39254518;26183757;13070761;37724977;-24654216;4;5;128;271;750;Perdida
Zonas Secundarias;TASA Pasto;2021;jun;64040222;37046190;26994032;46680592;-19686560;4;5;188;409;750;Perdida
Zonas Secundarias;TASA Pasto;2021;jul;65878115;38365860;27512255;35092214;-7579959;4;6;193;426;910;Perdida
Zonas Secundarias;TASA Pasto;2021;ago;73645868;39908050;33737818;33660166;77652;4;5;219;496;910;Perdida
Zonas Secundarias;TASA Pasto;2021;sep;93350754;48226655;45124099;39460223;5663876;4;5;253;593;910;Baja
Zonas Secundarias;TASA Pasto;2021;oct;89966076;41663376;48302700;35514233;12788467;4;6;237;596;910;Baja
Zonas Secundarias;TASA Pasto;2021;nov;81427264;40362385;41064879;43316826;-2251947;4;5;188;522;750;Perdida
Zonas Secundarias;TASA Pasto;2021;dic;75719046;39695635;36023411;33321763;2701648;4;5;225;496;750;Baja
Zonas Secundarias;TASA Pasto;2022;ene;54601552;31593094;23008458;26677466;-3669008;4;6;162;328;910;Perdida
Zonas Secundarias;TASA Pasto;2022;feb;80597195;40262465;40334730;35368630;4966100;4;6;234;487;910;Baja
Zonas Secundarias;TASA Pasto;2022;mar;96089007;47369505;48719502;40644460;8075042;4;6;235;610;910;Baja
Zonas Secundarias;TASA Pasto;2022;abr;88903534;47841387;41062147;34889808;6172339;4;6;228;542;910;Baja
Zonas Secundarias;TASA Pasto;2022;may;91013673;48583387;42430286;32306203;10124083;4;6;223;546;910;Baja
Zonas Secundarias;TASA Pasto;2022;jun;84856499;47195091;37661408;39307285;-1645877;4;6;194;473;910;Perdida
Zonas Secundarias;TASA Pasto;2022;jul;92050418;48765116;43285302;39538002;3747300;4;6;236;490;910;Baja
Zonas Secundarias;TASA Pasto;2022;ago;87244651;43489845;43754806;37930782;5824024;4;6;240;495;910;Baja
Zonas Secundarias;TASA Pasto;2022;sep;93670655;53821991;39848664;38541206;1307458;4;6;215;500;910;Baja
Zonas Secundarias;TASA Pasto;2022;oct;75936539;42510489;33426050;33652171;-226121;4;6;202;422;910;Perdida
Zonas Secundarias;TASA Pasto;2022;nov;87800794;45819381;41981413;47850271;-5868858;4;6;212;513;910;Perdida
Zonas Secundarias;TASA Pasto;2022;dic;82921826;37293390;45628436;55289846;-9661410;4;6;226;479;910;Perdida
Zonas Secundarias;TASA Pasto;2023;ene;70904864;36843886;34060978;37600042;-3539064;5;6;169;396;910;Perdida
Zonas Secundarias;TASA Pasto;2023;feb;95167983;49668198;45499785;47263012;-1763227;5;6;189;519;910;Perdida
Zonas Secundarias;TASA Pasto;2023;mar;105695890;56727387;48968503;50152212;-1183709;5;6;230;554;910;Perdida
Zonas Secundarias;TASA Pasto;2023;abr;90996692;50770658;40226034;45272156;-5046122;4;6;189;484;910;Perdida
Zonas Secundarias;TASA Pasto;2023;may;112606096;58790197;53815899;42591200;11224699;5;6;235;585;910;Baja
Zonas Secundarias;TASA Pasto;2023;jun;114344919;60251304;54093615;32130425;21963190;5;6;214;576;910;Baja
Zonas Secundarias;TASA Pasto;2023;jul;93249090;52811044;40438046;62778895;-22340849;5;5;209;490;910;Perdida
Zonas Secundarias;TASA Pasto;2023;ago;99981686;58636875;41344811;53166210;-11821399;5;6;225;482;910;Perdida
Zonas Secundarias;TASA Pasto;2023;sep;122679479;63793029;58886450;54838821;4047629;5;6;225;724;910;Baja
Zonas Secundarias;TASA Pasto;2023;oct;94588005;53609983;40978022;49148358;-8170336;5;6;222;487;910;Perdida
Zonas Secundarias;TASA Pasto;2023;nov;85797464;48795178;37002286;82570189;-45567903;5;6;189;432;910;Perdida
Zonas Secundarias;TASA Pasto;2023;dic;113558996;53359713;60199283;24036344;36162939;5;6;236;525;910;Media
Zonas Secundarias;TASA Pasto;2024;ene;92008214;50891568;41116646;48627077;-7510431;5;5;191;400;910;Perdida
Zonas Secundarias;TASA Pasto;2024;feb;96412813;51358418;45054395;60123694;-15069299;5;5;219;480;910;Perdida
Zonas Secundarias;TASA Pasto;2024;mar;104980096;54344882;50635214;49755103;880111;5;5;202;463;910;Perdida
Zonas Secundarias;TASA Pasto;2024;abr;121072172;66248094;54824078;76074452;-21250374;5;5;224;507;910;Perdida
Zonas Secundarias;TASA Pasto;2024;may;98065452;53451049;44614403;55276304;-10661901;4;6;217;436;910;Perdida
Zonas Secundarias;TASA Pasto;2024;jun;111692634;76382859;35309775;60202553;-24892778;4;6;197;436;910;Perdida
Zonas Secundarias;TASA Pasto;2024;jul;125494282;63115647;62378635;44171561;18207074;4;6;205;500;910;Baja
Zonas Secundarias;TASA Pasto;2024;ago;96331841;59670886;36660955;60044955;-23384000;4;6;226;420;910;Perdida
Zonas Secundarias;TASA Pasto;2024;sep;102601587;58304370;44297217;67672180;-23374963;4;6;218;452;910;Perdida
Zonas Secundarias;TASA Pasto;2024;oct;118018866;59738740;58280126;31217139;27062987;4;5;214;587;750;Media
Zonas Secundarias;TASA Pasto;2024;nov;111187809;67366943;43820866;52632530;-8811664;4;5;207;466;750;Perdida
Zonas Secundarias;TASA Pasto;2024;dic;123281841;64121746;59160095;43046691;16113404;4;5;209;516;750;Baja
Zonas Secundarias;Armenia;2021;ene;82129805;44649305;37480500;35575510;1904990;4;9;205;793;1140;Baja
Zonas Secundarias;Armenia;2021;feb;92569708;48677263;43892445;41177181;2715264;4;9;181;876;1140;Baja
Zonas Secundarias;Armenia;2021;mar;90507469;53999416;36508053;40127393;-3619340;4;10;181;894;1140;Perdida
Zonas Secundarias;Armenia;2021;abr;83205318;54583597;28621721;46174170;-17552449;4;10;182;888;1140;Perdida
Zonas Secundarias;Armenia;2021;may;61872775;53223411;8649364;36820744;-28171380;4;10;127;605;1140;Perdida
Zonas Secundarias;Armenia;2021;jun;82505298;55357914;27147384;43817954;-16670570;4;10;199;828;1140;Perdida
Zonas Secundarias;Armenia;2021;jul;86048453;59808305;26240148;41057246;-14817098;4;10;201;843;1140;Perdida
Zonas Secundarias;Armenia;2021;ago;89218358;59196788;30021570;44809818;-14788248;4;10;185;848;1140;Perdida
Zonas Secundarias;Armenia;2021;sep;110163721;62317419;47846302;45689107;2157195;4;9;229;1009;1140;Baja
Zonas Secundarias;Armenia;2021;oct;75165926;51759102;23406824;39263437;-15856613;3;9;188;685;1140;Perdida
Zonas Secundarias;Armenia;2021;nov;100176701;56797725;43378976;38977850;4401126;3;9;177;1056;1140;Baja
Zonas Secundarias;Armenia;2021;dic;88302447;51775493;36526954;44259088;-7732134;4;9;239;799;1140;Perdida
Zonas Secundarias;Armenia;2022;ene;84311490;46969078;37342412;42317362;-4974950;4;9;200;817;1140;Perdida
Zonas Secundarias;Armenia;2022;feb;101955025;56228789;45726236;43078399;2647837;4;10;190;1011;1140;Baja
Zonas Secundarias;Armenia;2022;mar;105798289;66299364;39498925;47992199;-8493274;4;10;221;1014;1140;Perdida
Zonas Secundarias;Armenia;2022;abr;112514821;58712178;53802643;46990463;6812180;4;10;214;1012;1140;Baja
Zonas Secundarias;Armenia;2022;may;94878911;62601397;32277514;54064759;-21787245;4;10;202;773;1140;Perdida
Zonas Secundarias;Armenia;2022;jun;97922045;60252143;37669902;53088292;-15418390;4;10;206;849;1140;Perdida
Zonas Secundarias;Armenia;2022;jul;88623843;48490774;40133069;50393723;-10260654;4;9;188;812;1140;Perdida
Zonas Secundarias;Armenia;2022;ago;87161793;47311907;39849886;62264579;-22414693;5;8;206;741;1140;Perdida
Zonas Secundarias;Armenia;2022;sep;81570502;52516622;29053880;47423005;-18369125;6;9;181;676;1140;Perdida
Zonas Secundarias;Armenia;2022;oct;97673131;59305921;38367210;56574167;-18206957;6;9;195;719;1140;Perdida
Zonas Secundarias;Armenia;2022;nov;81086407;50910117;30176290;59072448;-28896158;8;7;185;705;1140;Perdida
Zonas Secundarias;Armenia;2022;dic;90656374;73059524;17596850;86252618;-68655768;5;9;206;851;980;Perdida
Zonas Secundarias;Armenia;2023;ene;110062521;60556151;49506370;56490182;-6983812;4;10;222;927;1140;Perdida
Zonas Secundarias;Armenia;2023;feb;96209109;60797797;35411312;58130178;-22718866;4;10;183;802;1140;Perdida
Zonas Secundarias;Armenia;2023;mar;102064537;64579314;37485223;64101207;-26615984;5;10;200;862;1140;Perdida
Zonas Secundarias;Armenia;2023;abr;81126330;65678377;15447953;44381494;-28933541;5;11;144;679;1140;Perdida
Zonas Secundarias;Armenia;2023;may;109248898;78771690;30477208;46690755;-16213547;5;11;193;794;1140;Perdida
Zonas Secundarias;Armenia;2023;jun;108024521;73096892;34927629;54117227;-19189598;5;11;159;691;1140;Perdida
Zonas Secundarias;Armenia;2023;jul;96141137;73675553;22465584;60932025;-38466441;5;11;184;681;1140;Perdida
Zonas Secundarias;Armenia;2023;ago;92989411;65173111;27816300;61037769;-33221469;5;10;181;713;1140;Perdida
Zonas Secundarias;Armenia;2023;sep;80813040;53166309;27646731;51178196;-23531465;4;9;136;596;1140;Perdida
Zonas Secundarias;Armenia;2023;oct;118886929;78757034;40129895;57466792;-17336897;4;8;189;802;1140;Perdida
Zonas Secundarias;Armenia;2023;nov;94807605;61858444;32949161;59596779;-26647618;3;11;134;722;1300;Perdida
Zonas Secundarias;Armenia;2023;dic;89506873;77930011;11576862;55396552;-43819690;4;11;147;608;1300;Perdida
Zonas Secundarias;Armenia;2024;ene;96431620;63121287;33310333;54525960;-21215627;4;9;144;755;980;Perdida
Zonas Secundarias;Armenia;2024;feb;99253723;72365937;26887786;51431051;-24543265;3;10;150;690;1140;Perdida
Zonas Secundarias;Armenia;2024;mar;75512756;67398420;8114336;54061941;-45947605;4;10;154;542;1140;Perdida
Zonas Secundarias;Armenia;2024;abr;100125544;69003772;31121772;50758213;-19636441;4;9;167;663;1140;Perdida
Zonas Secundarias;Armenia;2024;may;85371933;59656065;25715868;54689678;-28973810;4;9;137;562;1300;Perdida
Zonas Secundarias;Armenia;2024;jun;91714904;66197719;25517185;48632793;-23115608;3;9;107;612;1300;Perdida
Zonas Secundarias;Armenia;2024;jul;98573478;81701039;16872439;52175330;-35302891;3;10;151;666;1300;Perdida
Zonas Secundarias;Armenia;2024;ago;89952872;67385363;22567509;63480836;-40913327;4;10;129;648;1300;Perdida
Zonas Secundarias;Armenia;2024;sep;105164723;78956462;26208261;56361393;-30153132;4;11;134;699;1460;Perdida
Zonas Secundarias;Armenia;2024;oct;90816418;62378234;28438184;61509411;-33071227;4;11;157;558;1460;Perdida
Zonas Secundarias;Armenia;2024;nov;106763209;85570158;21193051;60494471;-39301420;4;12;129;775;1460;Perdida
Zonas Secundarias;Armenia;2024;dic;83896483;68154184;15742299;62752626;-47010327;4;11;145;447;1300;Perdida
Zonas Secundarias;Armenia Vitrina;2021;ene;17267292;5168555;12098737;2589244;9509493;0;1;61;123;0;Alta
Zonas Secundarias;Armenia Vitrina;2021;feb;27856962;5697877;22159085;8029022;14130063;0;1;89;188;0;Alta
Zonas Secundarias;Armenia Vitrina;2021;mar;28402002;5913215;22488787;4003216;18485571;0;1;104;196;0;Alta
Zonas Secundarias;Armenia Vitrina;2021;abr;34638280;6173473;28464807;3321733;25143074;1;1;110;250;160;Alta
Zonas Secundarias;Armenia Vitrina;2021;may;7963302;4781573;3181729;10291884;-7110155;1;1;33;50;160;Perdida
Zonas Secundarias;Armenia Vitrina;2021;jun;34366341;8464418;25901923;9285776;16616147;1;1;109;204;160;Alta
Zonas Secundarias;Armenia Vitrina;2021;jul;39763779;10717102;29046677;5473832;23572845;1;1;146;243;160;Alta
Zonas Secundarias;Armenia Vitrina;2021;ago;34202873;7798212;26404661;8467141;17937520;1;1;110;216;160;Alta
Zonas Secundarias;Armenia Vitrina;2021;sep;38038625;9557473;28481152;6034875;22446277;1;1;131;237;160;Alta
Zonas Secundarias;Armenia Vitrina;2021;oct;34056858;10037297;24019561;7164938;16854623;1;2;132;203;320;Alta
Zonas Secundarias;Armenia Vitrina;2021;nov;39350594;14610837;24739757;11155531;13584226;1;2;116;236;320;Media
Zonas Secundarias;Armenia Vitrina;2021;dic;38865415;12598342;26267073;6046562;20220511;1;3;135;244;480;Alta
Zonas Secundarias;Armenia Vitrina;2022;ene;39974854;13991431;25983423;8849427;17133996;1;3;135;222;480;Media
Zonas Secundarias;Armenia Vitrina;2022;feb;35215963;13395138;21820825;6589745;15231080;1;3;122;205;480;Alta
Zonas Secundarias;Armenia Vitrina;2022;mar;42131371;15046955;27084416;6363912;20720504;1;3;135;228;480;Alta
Zonas Secundarias;Armenia Vitrina;2022;abr;39531276;18457531;21073745;3618351;17455394;0;4;118;224;480;Alta
Zonas Secundarias;Armenia Vitrina;2022;may;35153388;17676143;17477245;3272003;14205242;0;4;101;203;480;Media
Zonas Secundarias;Armenia Vitrina;2022;jun;38965830;15588520;23377310;4484830;18892480;0;4;110;222;480;Alta
Zonas Secundarias;Armenia Vitrina;2022;jul;39584931;17714661;21870270;4241392;17628878;0;4;110;209;480;Alta
Zonas Secundarias;Armenia Vitrina;2022;ago;51794722;20731138;31063584;16227847;14835737;0;4;145;254;480;Media
Zonas Secundarias;Armenia Vitrina;2022;sep;37042749;20194361;16848388;9672468;7175920;0;4;107;190;480;Baja
Zonas Secundarias;Armenia Vitrina;2022;oct;38572547;18357344;20215203;4028936;16186267;0;4;108;208;480;Media
Zonas Secundarias;Armenia Vitrina;2022;nov;33733655;19322841;14410814;8277846;6132968;0;4;106;163;640;Baja
Zonas Secundarias;Armenia Vitrina;2022;dic;45567549;20085073;25482476;4309738;21172738;0;4;137;241;480;Alta
Zonas Secundarias;Armenia Vitrina;2023;ene;29273613;18576449;10697164;3820511;6876653;0;4;82;144;480;Media
Zonas Secundarias;Armenia Vitrina;2023;feb;29982518;20936154;9046364;2485944;6560420;0;4;84;151;480;Baja
Zonas Secundarias;Armenia Vitrina;2023;mar;48406682;26418845;21987837;9957637;12030200;0;4;121;226;480;Media
Zonas Secundarias;Armenia Vitrina;2023;abr;31523658;18818455;12705203;6415829;6289374;0;4;88;159;480;Baja
Zonas Secundarias;Armenia Vitrina;2023;may;39965180;28492089;11473091;3450788;8022303;0;4;107;188;480;Baja
Zonas Secundarias;Armenia Vitrina;2023;jun;34562770;23638232;10924538;9549918;1374620;0;4;100;179;480;Baja
Zonas Secundarias;Armenia Vitrina;2023;jul;39716572;21554860;18161712;3573840;14587872;0;4;121;202;480;Media
Zonas Secundarias;Armenia Vitrina;2023;ago;51941535;25023847;26917688;9275401;17642287;0;3;128;249;320;Media
Zonas Secundarias;Armenia Vitrina;2023;sep;44236916;17625618;26611298;5052836;21558462;0;3;111;214;320;Alta
Zonas Secundarias;Armenia Vitrina;2023;oct;37648191;21510022;16138169;3379260;12758909;0;2;102;159;160;Media
Zonas Secundarias;Armenia Vitrina;2023;nov;44155567;17823780;26331787;3406720;22925067;0;2;105;186;160;Alta
Zonas Secundarias;Armenia Vitrina;2023;dic;51195026;20546390;30648636;4236242;26412394;0;2;96;247;160;Alta
Zonas Secundarias;Armenia Vitrina;2024;ene;53976715;19341785;34634930;3312369;31322561;0;2;121;250;160;Alta
Zonas Secundarias;Armenia Vitrina;2024;feb;43422781;21301634;22121147;4572524;17548623;0;2;91;156;160;Media
Zonas Secundarias;Armenia Vitrina;2024;mar;44278998;21419078;22859920;3178453;19681467;0;2;91;171;160;Alta
Zonas Secundarias;Armenia Vitrina;2024;abr;40753075;18530171;22222904;3445456;18777448;0;2;95;158;160;Alta
Zonas Secundarias;Armenia Vitrina;2024;may;43299775;25623849;17675926;2248199;15427727;0;2;96;165;160;Media
Zonas Secundarias;Armenia Vitrina;2024;jun;34430455;51205985;-16775530;2077753;-18853283;0;2;87;139;160;Perdida
Zonas Secundarias;Armenia Vitrina;2024;jul;40787842;33507087;7280755;1897859;5382896;0;2;102;158;160;Baja
Zonas Secundarias;Armenia Vitrina;2024;ago;40447399;20425671;20021728;6356613;13665115;0;2;90;165;160;Media
Zonas Secundarias;Armenia Vitrina;2024;sep;41183875;20119423;21064452;1922798;19141654;0;2;91;179;160;Alta
Zonas Secundarias;Armenia Vitrina;2024;oct;55765272;23869122;31896150;2257693;29638457;0;2;120;245;160;Alta
Zonas Secundarias;Armenia Vitrina;2024;nov;33548122;12810165;20737957;3339200;17398757;0;2;82;130;160;Alta
Zonas Secundarias;Armenia Vitrina;2024;dic;55099051;14620538;40478513;8590896;31887617;0;2;115;197;160;Alta
Zonas Secundarias;Barrancabermeja;2021;ene;102081121;57954165;44126956;33671156;10455800;3;7;296;635;800;Baja
Zonas Secundarias;Barrancabermeja;2021;feb;99626111;53745984;45880127;35109159;10770968;3;7;321;637;800;Baja
Zonas Secundarias;Barrancabermeja;2021;mar;105183229;57534512;47648717;37624317;10024400;3;7;319;659;800;Baja
Zonas Secundarias;Barrancabermeja;2021;abr;101053584;54956142;46097442;31938820;14158622;3;7;299;639;800;Baja
Zonas Secundarias;Barrancabermeja;2021;may;100507319;58653563;41853756;37480968;4372788;3;7;295;616;800;Baja
Zonas Secundarias;Barrancabermeja;2021;jun;97260588;53858776;43401812;34877603;8524209;3;7;310;600;800;Baja
Zonas Secundarias;Barrancabermeja;2021;jul;112813433;62480453;50332980;32855915;17477065;3;7;328;634;800;Baja
Zonas Secundarias;Barrancabermeja;2021;ago;121278460;64643629;56634831;40263289;16371542;4;7;337;753;800;Baja
Zonas Secundarias;Barrancabermeja;2021;sep;119471899;63603106;55868793;66151051;-10282258;3;7;339;722;800;Perdida
Zonas Secundarias;Barrancabermeja;2021;oct;125059887;63462426;61597461;37195567;24401894;3;7;380;729;800;Baja
Zonas Secundarias;Barrancabermeja;2021;nov;103927092;52739454;51187638;40218228;10969410;4;7;309;611;800;Baja
Zonas Secundarias;Barrancabermeja;2021;dic;148478994;75416395;73062599;43694237;29368362;4;7;410;880;800;Baja
Zonas Secundarias;Barrancabermeja;2022;ene;127596457;72820739;54775718;38524301;16251417;4;7;338;697;800;Baja
Zonas Secundarias;Barrancabermeja;2022;feb;128462468;69137680;59324788;50307463;9017325;4;8;330;730;960;Baja
Zonas Secundarias;Barrancabermeja;2022;mar;128392871;72970901;55421970;44426167;10995803;4;8;326;741;960;Baja
Zonas Secundarias;Barrancabermeja;2022;abr;105055786;57509016;47546770;37145529;10401241;4;7;298;627;800;Baja
Zonas Secundarias;Barrancabermeja;2022;may;143540753;71570747;71970006;57266973;14703033;4;7;371;810;800;Baja
Zonas Secundarias;Barrancabermeja;2022;jun;121400588;64356360;57044228;40327713;16716515;5;7;316;692;960;Baja
Zonas Secundarias;Barrancabermeja;2022;jul;144222629;74055516;70167113;48800282;21366831;5;6;314;774;800;Baja
Zonas Secundarias;Barrancabermeja;2022;ago;152258656;68963090;83295566;57654032;25641534;4;7;355;884;800;Baja
Zonas Secundarias;Barrancabermeja;2022;sep;151669315;72480402;79188913;44354025;34834888;5;7;365;851;960;Media
Zonas Secundarias;Barrancabermeja;2022;oct;162142165;78782785;83359380;67764393;15594987;5;7;329;835;960;Baja
Zonas Secundarias;Barrancabermeja;2022;nov;145655423;64690180;80965243;49511175;31454068;4;8;308;771;1120;Baja
Zonas Secundarias;Barrancabermeja;2022;dic;152865731;72142124;80723607;58038834;22684773;5;8;358;813;960;Baja
Zonas Secundarias;Barrancabermeja;2023;ene;154692204;76796674;77895530;53386560;24508970;5;8;346;785;960;Baja
Zonas Secundarias;Barrancabermeja;2023;feb;182425754;81877670;100548084;53545254;47002830;5;8;368;926;960;Media
Zonas Secundarias;Barrancabermeja;2023;mar;136462386;69988306;66474080;48279934;18194146;5;8;304;717;960;Baja
Zonas Secundarias;Barrancabermeja;2023;abr;168815976;89452582;79363394;33649269;45714125;5;7;332;815;800;Media
Zonas Secundarias;Barrancabermeja;2023;may;170014871;100569532;69445339;59061132;10384207;5;8;354;836;960;Baja
Zonas Secundarias;Barrancabermeja;2023;jun;162996155;85956095;77040060;64284413;12755647;5;7;323;797;960;Baja
Zonas Secundarias;Barrancabermeja;2023;jul;154254580;82581683;71672897;60168893;11504004;5;7;320;772;960;Baja
Zonas Secundarias;Barrancabermeja;2023;ago;135597224;76872420;58724804;58103805;620999;5;7;287;685;960;Perdida
Zonas Secundarias;Barrancabermeja;2023;sep;120587578;56623402;63964176;77058363;-13094187;5;7;238;611;960;Perdida
Zonas Secundarias;Barrancabermeja;2023;oct;136445984;82763197;53682787;43816140;9866647;4;8;252;620;960;Baja
Zonas Secundarias;Barrancabermeja;2023;nov;124271399;72787718;51483681;48007782;3475899;4;8;258;630;960;Baja
Zonas Secundarias;Barrancabermeja;2023;dic;144216856;71199648;73017208;56136847;16880361;4;8;295;748;960;Baja
Zonas Secundarias;Barrancabermeja;2024;ene;167694448;85136827;82557621;51922341;30635280;4;8;311;820;960;Baja
Zonas Secundarias;Barrancabermeja;2024;feb;129078578;80385250;48693328;64506163;-15812835;4;7;232;605;800;Perdida
Zonas Secundarias;Barrancabermeja;2024;mar;145035885;88108607;56927278;73106592;-16179314;3;8;259;659;960;Perdida
Zonas Secundarias;Barrancabermeja;2024;abr;158556944;77996650;80560294;67357558;13202736;3;8;279;726;960;Baja
Zonas Secundarias;Barrancabermeja;2024;may;159031704;93200919;65830785;56057703;9773082;3;8;283;753;960;Baja
Zonas Secundarias;Barrancabermeja;2024;jun;173130038;86990621;86139417;59298939;26840478;3;8;269;752;960;Baja
Zonas Secundarias;Barrancabermeja;2024;jul;163261155;84874827;78386328;62320376;16065952;3;8;292;795;960;Baja
Zonas Secundarias;Barrancabermeja;2024;ago;163296485;88022844;75273641;47793767;27479874;3;8;279;772;960;Baja
Zonas Secundarias;Barrancabermeja;2024;sep;152750497;82599435;70151062;52831882;17319180;3;8;258;727;960;Baja
Zonas Secundarias;Barrancabermeja;2024;oct;179161637;95558483;83603154;52484353;31118801;3;9;278;756;960;Baja
Zonas Secundarias;Barrancabermeja;2024;nov;132458889;73163441;59295448;69894341;-10598893;3;9;261;619;960;Perdida
Zonas Secundarias;Barrancabermeja;2024;dic;157438094;83592240;73845854;51858561;21987293;3;8;288;664;960;Baja
Zonas Secundarias;Bucaramanga Colision;2021;ene;188389968;82697361;105692607;70306152;35386455;7;11;242;1671;1680;Baja
Zonas Secundarias;Bucaramanga Colision;2021;feb;153646848;85929078;67717770;72579067;-4861297;7;11;220;1284;1680;Perdida
Zonas Secundarias;Bucaramanga Colision;2021;mar;220013908;104599991;115413917;91376520;24037397;7;11;316;1916;1680;Baja
Zonas Secundarias;Bucaramanga Colision;2021;abr;228567840;103464977;125102863;86116844;38986019;6;11;307;1977;1680;Baja
Zonas Secundarias;Bucaramanga Colision;2021;may;185209090;105604792;79604298;73338097;6266201;6;11;217;1688;1680;Baja
Zonas Secundarias;Bucaramanga Colision;2021;jun;161809513;102664772;59144741;74531685;-15386944;6;12;275;1329;1680;Perdida
Zonas Secundarias;Bucaramanga Colision;2021;jul;201424136;106527465;94896671;76186331;18710340;5;12;309;1559;1680;Baja
Zonas Secundarias;Bucaramanga Colision;2021;ago;226261794;126580511;99681283;77123461;22557822;5;13;303;1991;1840;Baja
Zonas Secundarias;Bucaramanga Colision;2021;sep;296919572;147104371;149815201;95530986;54284215;6;13;381;2391;1840;Baja
Zonas Secundarias;Bucaramanga Colision;2021;oct;224999161;123738568;101260593;84615658;16644935;6;13;314;1864;1840;Baja
Zonas Secundarias;Bucaramanga Colision;2021;nov;256076120;136897960;119178160;89933586;29244574;6;13;322;2020;1840;Baja
Zonas Secundarias;Bucaramanga Colision;2021;dic;204216095;125657433;78558662;107147681;-28589019;7;13;295;1659;1840;Perdida
Zonas Secundarias;Bucaramanga Colision;2022;ene;211546810;112881913;98664897;87564907;11099990;7;13;222;2050;1840;Baja
Zonas Secundarias;Bucaramanga Colision;2022;feb;215991305;123329399;92661906;77339713;15322193;6;13;233;1825;1840;Baja
Zonas Secundarias;Bucaramanga Colision;2022;mar;237352057;129593960;107758097;94341417;13416680;6;13;252;2165;1840;Baja
Zonas Secundarias;Bucaramanga Colision;2022;abr;215568683;123305784;92262899;104542205;-12279306;6;13;283;1819;1680;Perdida
Zonas Secundarias;Bucaramanga Colision;2022;may;231852702;120830305;111022397;96674967;14347430;6;13;235;1997;1680;Baja
Zonas Secundarias;Bucaramanga Colision;2022;jun;252602917;134974012;117628905;106557485;11071420;6;13;283;2161;1680;Baja
Zonas Secundarias;Bucaramanga Colision;2022;jul;268341679;136059266;132282413;101725941;30556472;6;13;244;2101;1680;Baja
Zonas Secundarias;Bucaramanga Colision;2022;ago;263846773;156222918;107623855;102196766;5427089;7;11;256;2024;1320;Baja
Zonas Secundarias;Bucaramanga Colision;2022;sep;191974540;96917411;95057129;88639381;6417748;6;11;197;1523;1360;Baja
Zonas Secundarias;Bucaramanga Colision;2022;oct;240627562;126851824;113775738;93893590;19882148;6;12;224;1932;1360;Baja
Zonas Secundarias;Bucaramanga Colision;2022;nov;215287149;113762386;101524763;122755148;-21230385;6;11;196;1571;1840;Perdida
Zonas Secundarias;Bucaramanga Colision;2022;dic;194648841;118194809;76454032;105572576;-29118544;6;11;208;1716;1520;Perdida
Zonas Secundarias;Bucaramanga Colision;2023;ene;229744130;116514690;113229440;107008805;6220635;6;10;182;2066;1320;Baja
Zonas Secundarias;Bucaramanga Colision;2023;feb;232542993;124967790;107575203;89631097;17944106;6;10;198;2118;1320;Baja
Zonas Secundarias;Bucaramanga Colision;2023;mar;247362722;115450226;131912496;105321952;26590544;6;10;221;1943;1480;Baja
Zonas Secundarias;Bucaramanga Colision;2023;abr;168286844;97165187;71121657;84790866;-13669209;6;10;183;1159;1480;Perdida
Zonas Secundarias;Bucaramanga Colision;2023;may;254919969;131510738;123409231;90222652;33186579;6;10;212;1932;1480;Baja
Zonas Secundarias;Bucaramanga Colision;2023;jun;242243235;129904011;112339224;107595760;4743464;6;11;218;1678;1680;Baja
Zonas Secundarias;Bucaramanga Colision;2023;jul;246882110;134875869;112006241;103822494;8183747;6;11;242;2109;1680;Baja
Zonas Secundarias;Bucaramanga Colision;2023;ago;264734108;129041389;135692719;127901122;7791597;6;11;261;1874;1680;Baja
Zonas Secundarias;Bucaramanga Colision;2023;sep;226982154;119856212;107125942;124901284;-17775342;7;11;233;1585;1680;Perdida
Zonas Secundarias;Bucaramanga Colision;2023;oct;213459693;117643609;95816084;106645785;-10829701;6;12;214;1482;1680;Perdida
Zonas Secundarias;Bucaramanga Colision;2023;nov;236455797;121353392;115102405;104450457;10651948;6;12;264;1535;1680;Baja
Zonas Secundarias;Bucaramanga Colision;2023;dic;243429879;121696834;121733045;95413550;26319495;6;12;250;1603;1680;Baja
Zonas Secundarias;Bucaramanga Colision;2024;ene;254585243;128923578;125661665;101149558;24512107;6;12;236;1884;1680;Baja
Zonas Secundarias;Bucaramanga Colision;2024;feb;270842167;139745241;131096926;117664125;13432801;6;10;243;1891;1360;Baja
Zonas Secundarias;Bucaramanga Colision;2024;mar;241041977;137861121;103180856;112702719;-9521863;6;11;282;1386;1520;Perdida
Zonas Secundarias;Bucaramanga Colision;2024;abr;251668899;132910884;118758015;102379735;16378280;6;11;246;1616;1520;Baja
Zonas Secundarias;Bucaramanga Colision;2024;may;322628655;160886667;161741988;115589239;46152749;7;10;290;2049;1360;Baja
Zonas Secundarias;Bucaramanga Colision;2024;jun;255504941;134519813;120985128;104282183;16702945;7;10;240;1568;1360;Baja
Zonas Secundarias;Bucaramanga Colision;2024;jul;290078137;150310773;139767364;136138883;3628481;7;10;276;1886;1360;Baja
Zonas Secundarias;Bucaramanga Colision;2024;ago;299761842;141388435;158373407;124860588;33512819;8;10;304;1949;1360;Baja
Zonas Secundarias;Bucaramanga Colision;2024;sep;280927902;159529850;121398052;122362515;-964463;7;12;262;1743;1520;Perdida
Zonas Secundarias;Bucaramanga Colision;2024;oct;336481227;143521638;192959589;122244430;70715159;6;12;302;2298;1520;Baja
Zonas Secundarias;Bucaramanga Colision;2024;nov;312457976;142722894;169735082;118642097;51092985;6;12;270;2094;1520;Baja
Zonas Secundarias;Bucaramanga Colision;2024;dic;323685840;184250066;139435774;123127066;16308708;6;12;332;1759;1520;Baja
Zonas Secundarias;Bucaramanga Express;2021;ene;81250287;42693609;38556678;41450332;-2893654;3;4;292;577;480;Perdida
Zonas Secundarias;Bucaramanga Express;2021;feb;101628489;42523009;59105480;47601419;11504061;4;5;318;655;640;Baja
Zonas Secundarias;Bucaramanga Express;2021;mar;118642048;51615267;67026781;42249931;24776850;4;5;395;809;640;Baja
Zonas Secundarias;Bucaramanga Express;2021;abr;103717374;50499506;53217868;50246503;2971365;4;5;305;652;640;Baja
Zonas Secundarias;Bucaramanga Express;2021;may;71755028;37693239;34061789;47202356;-13140567;4;5;236;486;640;Perdida
Zonas Secundarias;Bucaramanga Express;2021;jun;116095581;53879128;62216453;49412419;12804034;4;5;341;748;640;Baja
Zonas Secundarias;Bucaramanga Express;2021;jul;138645423;55156453;83488970;54787993;28700977;4;5;349;699;640;Baja
Zonas Secundarias;Bucaramanga Express;2021;ago;161170082;57078013;104092069;50157933;53934136;4;5;364;841;640;Media
Zonas Secundarias;Bucaramanga Express;2021;sep;155563719;58481576;97082143;59051982;38030161;3;5;418;837;640;Media
Zonas Secundarias;Bucaramanga Express;2021;oct;182049109;69063518;112985591;58630588;54355003;4;5;391;899;640;Media
Zonas Secundarias;Bucaramanga Express;2021;nov;161551967;57638711;103913256;54223371;49689885;5;4;386;825;640;Media
Zonas Secundarias;Bucaramanga Express;2021;dic;171724817;58714614;113010203;63284024;49726179;5;5;441;909;800;Media
Zonas Secundarias;Bucaramanga Express;2022;ene;170004441;62005510;107998931;41738512;66260419;5;5;421;880;800;Media
Zonas Secundarias;Bucaramanga Express;2022;feb;148881390;53468788;95412602;71011217;24401385;5;4;350;744;640;Baja
Zonas Secundarias;Bucaramanga Express;2022;mar;177650573;58351455;119299118;47806762;71492356;5;4;414;959;640;Media
Zonas Secundarias;Bucaramanga Express;2022;abr;160299122;56741411;103557711;50815329;52742382;5;5;402;809;800;Media
Zonas Secundarias;Bucaramanga Express;2022;may;140986942;55209942;85777000;61205766;24571234;5;5;375;733;800;Baja
Zonas Secundarias;Bucaramanga Express;2022;jun;162263709;56650087;105613622;56899969;48713653;5;5;416;837;800;Media
Zonas Secundarias;Bucaramanga Express;2022;jul;168919254;63635282;105283972;66655566;38628406;6;6;422;839;960;Media
Zonas Secundarias;Bucaramanga Express;2022;ago;183702830;64136332;119566498;64986386;54580112;6;6;420;890;960;Media
Zonas Secundarias;Bucaramanga Express;2022;sep;157793321;59241313;98552008;97106415;1445593;6;5;375;786;800;Perdida
Zonas Secundarias;Bucaramanga Express;2022;oct;166305985;59290015;107015970;59269839;47746131;6;5;433;804;800;Media
Zonas Secundarias;Bucaramanga Express;2022;nov;172419137;61665118;110754019;97065585;13688434;6;5;417;850;800;Baja
Zonas Secundarias;Bucaramanga Express;2022;dic;198766139;51167815;147598324;77595762;70002562;5;3;504;974;480;Media
Zonas Secundarias;Bucaramanga Express;2023;ene;208968750;68082206;140886544;76906512;63980032;5;3;487;976;480;Media
Zonas Secundarias;Bucaramanga Express;2023;feb;151809997;41906799;109903198;52986843;56916355;5;2;385;764;320;Media
Zonas Secundarias;Bucaramanga Express;2023;mar;174612983;47767112;126845871;52756717;74089154;7;2;378;793;640;Media
Zonas Secundarias;Bucaramanga Express;2023;abr;162301608;44164453;118137155;66303312;51833843;7;2;396;687;640;Media
Zonas Secundarias;Bucaramanga Express;2023;may;162895876;141006526;21889350;56182861;-34293511;6;2;377;771;640;Perdida
Zonas Secundarias;Bucaramanga Express;2023;jun;197436811;89683009;107753802;99714159;8039643;7;2;458;829;640;Baja
Zonas Secundarias;Bucaramanga Express;2023;jul;174899206;59494004;115405202;84972915;30432287;5;2;404;800;480;Baja
Zonas Secundarias;Bucaramanga Express;2023;ago;172043369;67678101;104365268;62670630;41694638;7;2;400;826;640;Media
Zonas Secundarias;Bucaramanga Express;2023;sep;189216446;73130278;116086168;42949997;73136171;7;3;427;843;800;Media
Zonas Secundarias;Bucaramanga Express;2023;oct;173893556;76845565;97047991;92385883;4662108;5;5;397;701;800;Baja
Zonas Secundarias;Bucaramanga Express;2023;nov;183089764;76837219;106252545;81645985;24606560;5;5;380;757;800;Baja
Zonas Secundarias;Bucaramanga Express;2023;dic;615165349;85966118;529199231;57983587;471215644;5;5;476;1014;640;Alta
Zonas Secundarias;Bucaramanga Express;2024;ene;195988090;82119607;113868483;57068119;56800364;5;5;426;820;640;Media
Zonas Secundarias;Bucaramanga Express;2024;feb;193778568;85529819;108248749;67354254;40894495;4;6;395;738;640;Baja
Zonas Secundarias;Bucaramanga Express;2024;mar;167289983;84549237;82740746;57978354;24762392;4;6;358;652;640;Baja
Zonas Secundarias;Bucaramanga Express;2024;abr;176931673;84744621;92187052;60113655;32073397;4;4;336;655;480;Baja
Zonas Secundarias;Bucaramanga Express;2024;may;213968843;98581992;115386851;54332938;61053913;4;7;381;764;800;Media
Zonas Secundarias;Bucaramanga Express;2024;jun;192712460;90850059;101862401;61760323;40102078;4;7;337;722;800;Baja
Zonas Secundarias;Bucaramanga Express;2024;jul;219320148;105152947;114167201;57597683;56569518;4;7;405;751;800;Media
Zonas Secundarias;Bucaramanga Express;2024;ago;214806348;99789040;115017308;73311858;41705450;4;8;376;856;800;Baja
Zonas Secundarias;Bucaramanga Express;2024;sep;188454986;87799805;100655181;67048394;33606787;4;8;360;733;800;Baja
Zonas Secundarias;Bucaramanga Express;2024;oct;190265527;84990776;105274751;55379038;49895713;3;8;356;740;800;Media
Zonas Secundarias;Bucaramanga Express;2024;nov;214806566;96635665;118170901;72954968;45215933;3;7;346;783;800;Baja
Zonas Secundarias;Bucaramanga Express;2024;dic;367406477;103461924;263944553;76635537;187309016;3;7;435;892;800;Alta
Zonas Secundarias;Bucaramanga Principal;2021;ene;179839738;74211302;105628436;55328443;50299993;7;10;399;912;1370;Media
Zonas Secundarias;Bucaramanga Principal;2021;feb;146231900;75736518;70495382;58110761;12384621;6;9;346;901;1210;Baja
Zonas Secundarias;Bucaramanga Principal;2021;mar;160825616;71556606;89269010;66287829;22981181;6;9;379;806;1210;Baja
Zonas Secundarias;Bucaramanga Principal;2021;abr;101884517;53678508;48206009;57862197;-9656188;6;9;307;616;1210;Perdida
Zonas Secundarias;Bucaramanga Principal;2021;may;98511418;60617582;37893836;62670470;-24776634;6;9;302;546;1210;Perdida
Zonas Secundarias;Bucaramanga Principal;2021;jun;136817924;71170134;65647790;52185322;13462468;6;9;338;658;1210;Baja
Zonas Secundarias;Bucaramanga Principal;2021;jul;134800167;74160200;60639967;69047749;-8407782;6;9;393;853;1210;Perdida
Zonas Secundarias;Bucaramanga Principal;2021;ago;124606730;75685077;48921653;57454074;-8532421;6;9;345;781;1210;Perdida
Zonas Secundarias;Bucaramanga Principal;2021;sep;151062839;87720309;63342530;59378138;3964392;6;10;418;902;1370;Baja
Zonas Secundarias;Bucaramanga Principal;2021;oct;164259802;83893556;80366246;58822319;21543927;6;10;444;1045;1370;Baja
Zonas Secundarias;Bucaramanga Principal;2021;nov;155611772;85415291;70196481;61708800;8487681;6;10;384;973;1370;Baja
Zonas Secundarias;Bucaramanga Principal;2021;dic;112247069;71483929;40763140;76829224;-36066084;5;9;384;770;1210;Perdida
Zonas Secundarias;Bucaramanga Principal;2022;ene;156658636;83377544;73281092;62418149;10862943;6;9;396;895;1210;Baja
Zonas Secundarias;Bucaramanga Principal;2022;feb;123504533;70793794;52710739;66929581;-14218842;6;9;341;803;1210;Perdida
Zonas Secundarias;Bucaramanga Principal;2022;mar;154953270;85258444;69694826;54008919;15685907;6;9;373;956;1210;Baja
Zonas Secundarias;Bucaramanga Principal;2022;abr;160374072;82496401;77877671;76761564;1116107;7;8;360;952;1210;Perdida
Zonas Secundarias;Bucaramanga Principal;2022;may;159869286;86447224;73422062;75626950;-2204888;7;8;390;943;1210;Perdida
Zonas Secundarias;Bucaramanga Principal;2022;jun;149074609;78736036;70338573;73573342;-3234769;7;8;380;814;1210;Perdida
Zonas Secundarias;Bucaramanga Principal;2022;jul;160028749;86135959;73892790;67210307;6682483;6;8;393;897;1210;Baja
Zonas Secundarias;Bucaramanga Principal;2022;ago;182526626;92784930;89741696;52299265;37442431;2;9;441;1060;1370;Baja
Zonas Secundarias;Bucaramanga Principal;2022;sep;247067124;117438524;129628600;59517341;70111259;3;9;454;1110;1370;Media
Zonas Secundarias;Bucaramanga Principal;2022;oct;210430051;95249162;115180889;52146862;63034027;3;9;444;1092;1370;Media
Zonas Secundarias;Bucaramanga Principal;2022;nov;194546941;100208233;94338708;55637372;38701336;5;9;386;962;1530;Baja
Zonas Secundarias;Bucaramanga Principal;2022;dic;215145301;106656047;108489254;52710375;55778879;7;10;454;1168;1690;Media
Zonas Secundarias;Bucaramanga Principal;2023;ene;188953957;91900733;97053224;82592468;14460756;7;10;449;1010;1690;Baja
Zonas Secundarias;Bucaramanga Principal;2023;feb;183139271;95512835;87626436;91671136;-4044700;7;9;373;923;1440;Perdida
Zonas Secundarias;Bucaramanga Principal;2023;mar;209851749;109745324;100106425;84754734;15351691;7;9;463;1044;1440;Baja
Zonas Secundarias;Bucaramanga Principal;2023;abr;205476751;103487504;101989247;72766523;29222724;7;9;393;981;1440;Baja
Zonas Secundarias;Bucaramanga Principal;2023;may;226866398;122659847;104206551;62181491;42025060;7;9;469;1132;1690;Baja
Zonas Secundarias;Bucaramanga Principal;2023;jun;227729057;111515611;116213446;82468312;33745134;7;9;473;1084;1690;Baja
Zonas Secundarias;Bucaramanga Principal;2023;jul;204552316;107943606;96608710;90063294;6545416;8;8;393;993;1690;Baja
Zonas Secundarias;Bucaramanga Principal;2023;ago;193792438;94320529;99471909;85739580;13732329;9;8;391;996;1690;Baja
Zonas Secundarias;Bucaramanga Principal;2023;sep;169043493;70103495;98939998;105242180;-6302182;9;7;319;840;1530;Perdida
Zonas Secundarias;Bucaramanga Principal;2023;oct;176290973;105287358;71003615;105828100;-34824485;7;8;339;816;1370;Perdida
Zonas Secundarias;Bucaramanga Principal;2023;nov;199464870;109338409;90126461;60991200;29135261;7;8;328;949;1370;Baja
Zonas Secundarias;Bucaramanga Principal;2023;dic;137989225;78627516;59361709;57986522;1375187;8;7;308;815;1210;Perdida
Zonas Secundarias;Bucaramanga Principal;2024;ene;172537408;98794636;73742772;81151074;-7408302;8;7;310;780;1210;Perdida
Zonas Secundarias;Bucaramanga Principal;2024;feb;154255122;86809632;67445490;83685125;-16239635;8;8;246;727;1370;Perdida
Zonas Secundarias;Bucaramanga Principal;2024;mar;166414873;101763232;64651641;84874305;-20222664;9;9;256;723;1530;Perdida
Zonas Secundarias;Bucaramanga Principal;2024;abr;154460809;102994659;51466150;96545927;-45079777;9;9;304;679;1530;Perdida
Zonas Secundarias;Bucaramanga Principal;2024;may;145812445;83517506;62294939;89948639;-27653700;8;10;269;638;1530;Perdida
Zonas Secundarias;Bucaramanga Principal;2024;jun;191051903;101304965;89746938;84389949;5356989;8;10;287;717;1530;Baja
Zonas Secundarias;Bucaramanga Principal;2024;jul;151472451;87776825;63695626;85758845;-22063219;8;10;277;713;1530;Perdida
Zonas Secundarias;Bucaramanga Principal;2024;ago;163920927;97561180;66359747;88720531;-22360784;8;10;285;787;1530;Perdida
Zonas Secundarias;Bucaramanga Principal;2024;sep;144582996;91590763;52992233;83841274;-30849041;8;10;253;639;1530;Perdida
Zonas Secundarias;Bucaramanga Principal;2024;oct;163259771;84977852;78281919;87425274;-9143355;7;10;262;788;1530;Perdida
Zonas Secundarias;Bucaramanga Principal;2024;nov;188117580;97497709;90619871;109916548;-19296677;7;10;305;993;1530;Perdida
Zonas Secundarias;Bucaramanga Principal;2024;dic;199287995;109758024;89529971;67843545;21686426;7;10;317;835;1530;Baja
Zonas Secundarias;Carro Taller Villavicencio;2021;ene;21962144;6275722;15686422;9320246;6366176;0;1;32;144;160;Media
Zonas Secundarias;Carro Taller Villavicencio;2021;feb;20360168;6959529;13400639;6883067;6517572;0;1;28;123;160;Media
Zonas Secundarias;Carro Taller Villavicencio;2021;mar;19578255;8547864;11030391;3512639;7517752;0;1;28;129;160;Media
Zonas Secundarias;Carro Taller Villavicencio;2021;abr;29995737;8275201;21720536;10880527;10840009;0;1;34;182;160;Media
Zonas Secundarias;Carro Taller Villavicencio;2021;may;25004879;12773360;12231519;5981475;6250044;0;1;33;158;160;Media
Zonas Secundarias;Carro Taller Villavicencio;2021;jun;21776963;8238078;13538885;254164;13284721;0;1;26;153;160;Alta
Zonas Secundarias;Carro Taller Villavicencio;2021;jul;26939760;11262216;15677544;14045375;1632169;0;1;22;177;160;Baja
Zonas Secundarias;Carro Taller Villavicencio;2021;ago;27596690;11857245;15739445;6364915;9374530;0;1;34;184;160;Media
Zonas Secundarias;Carro Taller Villavicencio;2021;sep;36677534;11550950;25126584;11495060;13631524;0;1;39;233;160;Media
Zonas Secundarias;Carro Taller Villavicencio;2021;oct;35253578;10114219;25139359;9209698;15929661;0;1;44;240;160;Alta
Zonas Secundarias;Carro Taller Villavicencio;2021;nov;40401849;11634432;28767417;12986517;15780900;0;1;50;274;160;Media
Zonas Secundarias;Carro Taller Villavicencio;2021;dic;34517898;13551127;20966771;12156264;8810507;0;1;45;220;160;Media
Zonas Secundarias;Carro Taller Villavicencio;2022;ene;23853439;4743512;19109927;16596514;2513413;0;1;32;162;160;Baja
Zonas Secundarias;Carro Taller Villavicencio;2022;feb;42874733;17204262;25670471;20170018;5500453;0;2;58;271;320;Baja
Zonas Secundarias;Carro Taller Villavicencio;2022;mar;37185116;12990024;24195092;13275655;10919437;0;2;52;242;320;Media
Zonas Secundarias;Carro Taller Villavicencio;2022;abr;50628939;24819832;25809107;6178545;19630562;0;2;62;293;320;Media
Zonas Secundarias;Carro Taller Villavicencio;2022;may;48593485;18814992;29778493;6137790;23640703;0;2;55;282;320;Alta
Zonas Secundarias;Carro Taller Villavicencio;2022;jun;51307926;14940496;36367430;15955270;20412160;0;2;61;326;320;Media
Zonas Secundarias;Carro Taller Villavicencio;2022;jul;50691570;15758198;34933372;7560726;27372646;0;2;57;312;320;Alta
Zonas Secundarias;Carro Taller Villavicencio;2022;ago;47842734;14888910;32953824;17593163;15360661;0;2;57;305;320;Media
Zonas Secundarias;Carro Taller Villavicencio;2022;sep;50379878;16305551;34074327;24918276;9156051;0;2;81;312;320;Baja
Zonas Secundarias;Carro Taller Villavicencio;2022;oct;45645885;12882876;32763009;27775588;4987421;0;2;52;285;320;Baja
Zonas Secundarias;Carro Taller Villavicencio;2022;nov;58225047;26669669;31555378;4493334;27062044;0;2;79;372;320;Alta
Zonas Secundarias;Carro Taller Villavicencio;2022;dic;47002128;37385714;9616414;31060246;-21443832;0;2;45;314;320;Perdida
Zonas Secundarias;Carro Taller Villavicencio;2023;ene;52777741;15904360;36873381;12586292;24287089;0;2;71;350;320;Alta
Zonas Secundarias;Carro Taller Villavicencio;2023;feb;39872710;17296352;22576358;12859960;9716398;0;2;48;239;320;Media
Zonas Secundarias;Carro Taller Villavicencio;2023;mar;59610080;31648418;27961662;8527713;19433949;0;2;65;358;320;Media
Zonas Secundarias;Carro Taller Villavicencio;2023;abr;64530077;29918634;34611443;17896706;16714737;0;2;63;355;320;Media
Zonas Secundarias;Carro Taller Villavicencio;2023;may;59658256;29283294;30374962;14840084;15534878;0;2;66;343;320;Media
Zonas Secundarias;Carro Taller Villavicencio;2023;jun;56268306;18837175;37431131;11550089;25881042;0;2;63;271;320;Alta
Zonas Secundarias;Carro Taller Villavicencio;2023;jul;57190167;26687170;30502997;16131041;14371956;0;2;43;287;320;Media
Zonas Secundarias;Carro Taller Villavicencio;2023;ago;8175029;14853993;-6678964;5344551;-12023515;0;2;18;56;320;Perdida
Zonas Secundarias;Carro Taller Villavicencio;2023;sep;4879454;9195937;-4316483;3564626;-7881109;0;2;8;32;320;Perdida
Zonas Secundarias;Carro Taller Villavicencio;2023;oct;26588959;13560498;13028461;22806922;-9778461;0;2;35;155;320;Perdida
Zonas Secundarias;Carro Taller Villavicencio;2023;nov;26475058;19584078;6890980;17806976;-10915996;0;2;36;172;320;Perdida
Zonas Secundarias;Carro Taller Villavicencio;2023;dic;61770073;16960867;44809206;3430830;41378376;0;2;66;388;320;Alta
Zonas Secundarias;Carro Taller Villavicencio;2024;ene;45921524;20828697;25092827;4397085;20695742;0;2;51;286;320;Alta
Zonas Secundarias;Carro Taller Villavicencio;2024;feb;70716448;26372457;44343991;10539494;33804497;0;2;59;416;320;Alta
Zonas Secundarias;Carro Taller Villavicencio;2024;mar;53624988;24298666;29326322;7745467;21580855;0;2;58;316;320;Media
Zonas Secundarias;Carro Taller Villavicencio;2024;abr;61240717;22042077;39198640;3302435;35896205;0;2;52;325;320;Alta
Zonas Secundarias;Carro Taller Villavicencio;2024;may;65566597;27876623;37689974;5049289;32640685;0;2;64;331;320;Alta
Zonas Secundarias;Carro Taller Villavicencio;2024;jun;44270052;106610838;-62340786;3897265;-66238051;0;2;53;202;320;Perdida
Zonas Secundarias;Carro Taller Villavicencio;2024;jul;74855680;85002157;-10146477;5185705;-15332182;0;2;95;412;320;Perdida
Zonas Secundarias;Carro Taller Villavicencio;2024;ago;86127941;34377481;51750460;3886953;47863507;0;2;98;422;320;Alta
Zonas Secundarias;Carro Taller Villavicencio;2024;sep;84038214;28275479;55762735;13173840;42588895;0;2;106;466;320;Alta
Zonas Secundarias;Carro Taller Villavicencio;2024;oct;90036688;25372090;64664598;5282748;59381850;0;2;98;457;320;Alta
Zonas Secundarias;Carro Taller Villavicencio;2024;nov;68124195;20041392;48082803;6092901;41989902;0;2;85;359;320;Alta
Zonas Secundarias;Carro Taller Villavicencio;2024;dic;60457033;20359752;40097281;19748212;20349069;0;2;85;316;320;Media
Zonas Secundarias;Cucuta Colision y Alistamiento;2021;ene;58851866;27896314;30955552;23216163;7739389;2;7;93;436;930;Baja
Zonas Secundarias;Cucuta Colision y Alistamiento;2021;feb;77746526;31628883;46117643;24094072;22023571;3;7;89;606;930;Media
Zonas Secundarias;Cucuta Colision y Alistamiento;2021;mar;69969563;34326198;35643365;29918858;5724507;3;7;92;480;930;Baja
Zonas Secundarias;Cucuta Colision y Alistamiento;2021;abr;69511714;33991685;35520029;24868713;10651316;2;7;115;433;930;Baja
Zonas Secundarias;Cucuta Colision y Alistamiento;2021;may;66790872;39659095;27131777;24006769;3125008;2;7;76;507;930;Baja
Zonas Secundarias;Cucuta Colision y Alistamiento;2021;jun;107656645;47044385;60612260;23762147;36850113;2;7;119;849;930;Media
Zonas Secundarias;Cucuta Colision y Alistamiento;2021;jul;71891801;40970153;30921648;27815142;3106506;2;7;112;589;770;Baja
Zonas Secundarias;Cucuta Colision y Alistamiento;2021;ago;57366885;43709251;13657634;23341146;-9683512;2;7;110;422;770;Perdida
Zonas Secundarias;Cucuta Colision y Alistamiento;2021;sep;83401760;52307297;31094463;29268475;1825988;2;7;149;772;770;Baja
Zonas Secundarias;Cucuta Colision y Alistamiento;2021;oct;81973851;48865643;33108208;31312112;1796096;2;6;127;698;770;Baja
Zonas Secundarias;Cucuta Colision y Alistamiento;2021;nov;81171325;48759305;32412020;31680744;731276;2;7;131;751;770;Perdida
Zonas Secundarias;Cucuta Colision y Alistamiento;2021;dic;89401042;49535705;39865337;28920027;10945310;2;7;108;760;770;Baja
Zonas Secundarias;Cucuta Colision y Alistamiento;2022;ene;59741061;40269834;19471227;28381865;-8910638;2;7;70;732;770;Perdida
Zonas Secundarias;Cucuta Colision y Alistamiento;2022;feb;73906219;41314767;32591452;29397516;3193936;2;8;98;854;930;Baja
Zonas Secundarias;Cucuta Colision y Alistamiento;2022;mar;72512144;43419944;29092200;34258769;-5166569;2;8;99;773;930;Perdida
Zonas Secundarias;Cucuta Colision y Alistamiento;2022;abr;66426695;44021530;22405165;28426320;-6021155;2;8;102;663;930;Perdida
Zonas Secundarias;Cucuta Colision y Alistamiento;2022;may;78892317;50029434;28862883;30867369;-2004486;2;7;91;786;930;Perdida
Zonas Secundarias;Cucuta Colision y Alistamiento;2022;jun;101851138;49625460;52225678;27374887;24850791;2;7;124;904;930;Media
Zonas Secundarias;Cucuta Colision y Alistamiento;2022;jul;74619095;45099381;29519714;40072278;-10552564;3;7;82;717;930;Perdida
Zonas Secundarias;Cucuta Colision y Alistamiento;2022;ago;75804648;42932216;32872432;39952269;-7079837;3;7;102;724;930;Perdida
Zonas Secundarias;Cucuta Colision y Alistamiento;2022;sep;85026646;46960249;38066397;35826226;2240171;3;7;74;856;930;Baja
Zonas Secundarias;Cucuta Colision y Alistamiento;2022;oct;71689163;48603241;23085922;36345619;-13259697;3;7;70;700;930;Perdida
Zonas Secundarias;Cucuta Colision y Alistamiento;2022;nov;82765666;49854547;32911119;42821162;-9910043;4;6;84;818;1090;Perdida
Zonas Secundarias;Cucuta Colision y Alistamiento;2022;dic;49921041;44590320;5330721;43411288;-38080567;2;8;59;509;930;Perdida
Zonas Secundarias;Cucuta Colision y Alistamiento;2023;ene;81170499;41337777;39832722;29906751;9925971;2;8;60;860;930;Baja
Zonas Secundarias;Cucuta Colision y Alistamiento;2023;feb;100074310;58125766;41948544;28381161;13567383;2;7;87;1131;770;Baja
Zonas Secundarias;Cucuta Colision y Alistamiento;2023;mar;100020150;48751087;51269063;33728257;17540806;2;7;67;1134;770;Baja
Zonas Secundarias;Cucuta Colision y Alistamiento;2023;abr;88786676;45517233;43269443;23912678;19356765;2;7;65;994;770;Baja
Zonas Secundarias;Cucuta Colision y Alistamiento;2023;may;86885908;44412021;42473887;40407863;2066024;2;5;66;777;770;Baja
Zonas Secundarias;Cucuta Colision y Alistamiento;2023;jun;88273216;42076847;46196369;44253170;1943199;2;5;84;754;770;Baja
Zonas Secundarias;Cucuta Colision y Alistamiento;2023;jul;91644955;61148481;30496474;37612863;-7116389;3;5;80;912;770;Perdida
Zonas Secundarias;Cucuta Colision y Alistamiento;2023;ago;102427358;52943600;49483758;40438187;9045571;3;5;92;979;770;Baja
Zonas Secundarias;Cucuta Colision y Alistamiento;2023;sep;109487692;42981692;66506000;30925840;35580160;3;5;101;1033;770;Media
Zonas Secundarias;Cucuta Colision y Alistamiento;2023;oct;66566694;43581909;22984785;36148806;-13164021;3;5;74;659;770;Perdida
Zonas Secundarias;Cucuta Colision y Alistamiento;2023;nov;105292335;55302252;49990083;43109777;6880306;2;5;96;1115;770;Baja
Zonas Secundarias;Cucuta Colision y Alistamiento;2023;dic;55392552;49410658;5981894;41840575;-35858681;4;5;100;995;770;Perdida
Zonas Secundarias;Cucuta Colision y Alistamiento;2024;ene;55218634;39581699;15636935;36902972;-21266037;4;4;57;619;610;Perdida
Zonas Secundarias;Cucuta Colision y Alistamiento;2024;feb;100028841;51444581;48584260;56213962;-7629702;4;4;93;902;610;Perdida
Zonas Secundarias;Cucuta Colision y Alistamiento;2024;mar;96164674;58958654;37206020;39856097;-2650077;4;4;74;800;610;Perdida
Zonas Secundarias;Cucuta Colision y Alistamiento;2024;abr;114788704;60518855;54269849;48185199;6084650;4;5;94;1072;770;Baja
Zonas Secundarias;Cucuta Colision y Alistamiento;2024;may;67003323;51096683;15906640;47326319;-31419679;4;7;66;520;770;Perdida
Zonas Secundarias;Cucuta Colision y Alistamiento;2024;jun;65675631;68610358;-2934727;37156737;-40091464;2;9;55;529;1000;Perdida
Zonas Secundarias;Cucuta Colision y Alistamiento;2024;jul;96536768;62188961;34347807;45386044;-11038237;2;9;95;790;1000;Perdida
Zonas Secundarias;Cucuta Colision y Alistamiento;2024;ago;105633873;75293008;30340865;45237763;-14896898;2;10;104;1048;1160;Perdida
Zonas Secundarias;Cucuta Colision y Alistamiento;2024;sep;108145483;70992979;37152504;37548214;-395710;2;10;108;938;1160;Perdida
Zonas Secundarias;Cucuta Colision y Alistamiento;2024;oct;84561478;67570401;16991077;33658752;-16667675;2;11;75;874;1160;Perdida
Zonas Secundarias;Cucuta Colision y Alistamiento;2024;nov;81983496;82310133;-326637;40030088;-40356725;2;10;78;785;1000;Perdida
Zonas Secundarias;Cucuta Colision y Alistamiento;2024;dic;98936234;74288433;24647801;37770754;-13122953;2;11;107;856;1160;Perdida
Zonas Secundarias;Cucuta Mecanica;2021;ene;93349350;43585778;49763572;49270304;493268;3;3;304;690;480;Perdida
Zonas Secundarias;Cucuta Mecanica;2021;feb;107552453;40723920;66828533;58386858;8441675;3;3;332;834;480;Baja
Zonas Secundarias;Cucuta Mecanica;2021;mar;125030060;48190175;76839885;57811269;19028616;3;3;329;929;480;Baja
Zonas Secundarias;Cucuta Mecanica;2021;abr;101987808;41000703;60987105;60871806;115299;4;3;317;800;480;Perdida
Zonas Secundarias;Cucuta Mecanica;2021;may;88085481;36804247;51281234;57090772;-5809538;4;3;246;642;480;Perdida
Zonas Secundarias;Cucuta Mecanica;2021;jun;103901496;44092235;59809261;63119409;-3310148;4;3;334;832;480;Perdida
Zonas Secundarias;Cucuta Mecanica;2021;jul;136736400;47744773;88991627;54545664;34445963;4;3;358;834;480;Media
Zonas Secundarias;Cucuta Mecanica;2021;ago;127038501;41872263;85166238;53616417;31549821;4;3;332;793;480;Media
Zonas Secundarias;Cucuta Mecanica;2021;sep;145793655;51226306;94567349;62751396;31815953;5;3;363;915;480;Baja
Zonas Secundarias;Cucuta Mecanica;2021;oct;136271694;45888456;90383238;56682133;33701105;4;3;348;880;480;Media
Zonas Secundarias;Cucuta Mecanica;2021;nov;124540896;43690115;80850781;62121917;18728864;5;3;308;741;640;Baja
Zonas Secundarias;Cucuta Mecanica;2021;dic;146020065;43728681;102291384;80750782;21540602;5;3;401;887;640;Baja
Zonas Secundarias;Cucuta Mecanica;2022;ene;139310135;51108937;88201198;57084674;31116524;5;3;346;824;640;Media
Zonas Secundarias;Cucuta Mecanica;2022;feb;139727949;42358031;97369918;64725016;32644902;5;3;311;931;640;Media
Zonas Secundarias;Cucuta Mecanica;2022;mar;151965269;43192807;108772462;66337707;42434755;4;3;353;966;640;Media
Zonas Secundarias;Cucuta Mecanica;2022;abr;152958407;49627141;103331266;47128242;56203024;3;4;371;980;640;Media
Zonas Secundarias;Cucuta Mecanica;2022;may;135576331;48235723;87340608;53809775;33530833;3;5;357;848;640;Media
Zonas Secundarias;Cucuta Mecanica;2022;jun;153380300;54487722;98892578;43819984;55072594;3;5;395;951;640;Media
Zonas Secundarias;Cucuta Mecanica;2022;jul;157590203;51723743;105866460;55454726;50411734;2;5;348;959;640;Media
Zonas Secundarias;Cucuta Mecanica;2022;ago;128874573;43143179;85731394;45690485;40040909;2;5;332;728;640;Media
Zonas Secundarias;Cucuta Mecanica;2022;sep;134266258;45786866;88479392;45456782;43022610;2;5;332;778;640;Media
Zonas Secundarias;Cucuta Mecanica;2022;oct;144146989;46599422;97547567;43887524;53660043;2;5;339;861;640;Media
Zonas Secundarias;Cucuta Mecanica;2022;nov;132120764;47285150;84835614;60842816;23992798;2;4;330;780;640;Baja
Zonas Secundarias;Cucuta Mecanica;2022;dic;166793138;51390681;115402457;57294359;58108098;6;3;378;927;800;Media
Zonas Secundarias;Cucuta Mecanica;2023;ene;140859949;47138379;93721570;65863092;27858478;5;3;340;773;640;Baja
Zonas Secundarias;Cucuta Mecanica;2023;feb;144332434;45426714;98905720;75246290;23659430;5;3;332;761;640;Baja
Zonas Secundarias;Cucuta Mecanica;2023;mar;162012643;49511042;112501601;64151258;48350343;7;3;372;894;960;Media
Zonas Secundarias;Cucuta Mecanica;2023;abr;141660489;44029062;97631427;77343291;20288136;7;3;334;702;960;Baja
Zonas Secundarias;Cucuta Mecanica;2023;may;131391065;93071007;38320058;67033213;-28713155;7;1;312;632;640;Perdida
Zonas Secundarias;Cucuta Mecanica;2023;jun;159063216;60262147;98801069;85396279;13404790;8;3;356;744;960;Baja
Zonas Secundarias;Cucuta Mecanica;2023;jul;139479005;52815750;86663255;91360796;-4697541;8;3;331;725;960;Perdida
Zonas Secundarias;Cucuta Mecanica;2023;ago;143421907;56171316;87250591;78614444;8636147;8;3;333;748;960;Baja
Zonas Secundarias;Cucuta Mecanica;2023;sep;116994023;37647398;79346625;69642195;9704430;8;3;307;555;960;Baja
Zonas Secundarias;Cucuta Mecanica;2023;oct;141983144;81494748;60488396;77644095;-17155699;5;5;337;615;800;Perdida
Zonas Secundarias;Cucuta Mecanica;2023;nov;128842962;53368010;75474952;72131976;3342976;3;5;282;534;800;Baja
Zonas Secundarias;Cucuta Mecanica;2023;dic;340353080;50025615;290327465;49987539;240339926;4;5;325;681;800;Alta
Zonas Secundarias;Cucuta Mecanica;2024;ene;143112460;64158098;78954362;74756028;4198334;4;5;316;625;800;Baja
Zonas Secundarias;Cucuta Mecanica;2024;feb;136571887;57723419;78848468;58179966;20668502;4;5;306;633;800;Baja
Zonas Secundarias;Cucuta Mecanica;2024;mar;111904118;56818258;55085860;62876872;-7791012;4;5;240;495;800;Perdida
Zonas Secundarias;Cucuta Mecanica;2024;abr;150844641;74467079;76377562;68795190;7582372;4;5;299;610;800;Baja
Zonas Secundarias;Cucuta Mecanica;2024;may;138436275;59871528;78564747;75416652;3148095;3;5;300;548;800;Baja
Zonas Secundarias;Cucuta Mecanica;2024;jun;165640595;61879526;103761069;74282824;29478245;5;3;331;665;570;Baja
Zonas Secundarias;Cucuta Mecanica;2024;jul;160363022;54675452;105687570;77871928;27815642;3;3;308;713;570;Baja
Zonas Secundarias;Cucuta Mecanica;2024;ago;151584774;55227716;96357058;59498597;36858461;3;3;298;646;570;Media
Zonas Secundarias;Cucuta Mecanica;2024;sep;132053184;49101423;82951761;73517190;9434571;3;3;249;603;570;Baja
Zonas Secundarias;Cucuta Mecanica;2024;oct;148166966;44421827;103745139;68189964;35555175;2;3;303;658;570;Media
Zonas Secundarias;Cucuta Mecanica;2024;nov;140815000;41098883;99716117;73075535;26640582;2;3;275;638;570;Baja
Zonas Secundarias;Cucuta Mecanica;2024;dic;209661095;38086939;171574156;73382644;98191512;2;3;327;702;570;Alta
Zonas Secundarias;Dos Quebradas Tasa;2021;ene;144946554;47532666;97413888;48543669;48870219;3;8;137;1579;1000;Media
Zonas Secundarias;Dos Quebradas Tasa;2021;feb;177327275;56506038;120821237;50903219;69918018;3;8;147;2101;1000;Media
Zonas Secundarias;Dos Quebradas Tasa;2021;mar;161198480;55009999;106188481;46124049;60064432;3;9;160;1677;1000;Media
Zonas Secundarias;Dos Quebradas Tasa;2021;abr;175690470;76003169;99687301;57899898;41787403;3;11;174;2067;1160;Media
Zonas Secundarias;Dos Quebradas Tasa;2021;may;61596395;79179330;-17582935;56623841;-74206776;3;12;88;651;1360;Perdida
Zonas Secundarias;Dos Quebradas Tasa;2021;jun;174960106;51570051;123390055;46635148;76754907;3;11;166;1891;1360;Alta
Zonas Secundarias;Dos Quebradas Tasa;2021;jul;143310411;67465901;75844510;46539011;29305499;2;12;162;1562;1520;Baja
Zonas Secundarias;Dos Quebradas Tasa;2021;ago;179109893;70418887;108691006;56048687;52642319;2;9;188;2021;1320;Media
Zonas Secundarias;Dos Quebradas Tasa;2021;sep;141822165;66055670;75766495;45561437;30205058;3;9;188;1438;1320;Baja
Zonas Secundarias;Dos Quebradas Tasa;2021;oct;166632881;72121584;94511297;60747245;33764052;4;10;195;1756;1200;Baja
Zonas Secundarias;Dos Quebradas Tasa;2021;nov;153852596;64419944;89432652;59527921;29904731;4;11;170;1657;1360;Baja
Zonas Secundarias;Dos Quebradas Tasa;2021;dic;129547363;61679431;67867932;60051700;7816232;4;11;157;1308;1360;Baja
Zonas Secundarias;Dos Quebradas Tasa;2022;ene;146028279;61535835;84492444;56051243;28441201;4;11;119;1729;1360;Baja
Zonas Secundarias;Dos Quebradas Tasa;2022;feb;126288560;59995638;66292922;52957478;13335444;4;10;124;1251;1360;Baja
Zonas Secundarias;Dos Quebradas Tasa;2022;mar;175594164;73334844;102259320;63046841;39212479;4;11;150;2118;1360;Media
Zonas Secundarias;Dos Quebradas Tasa;2022;abr;104961951;65176398;39785553;55957295;-16171742;4;12;124;1025;1360;Perdida
Zonas Secundarias;Dos Quebradas Tasa;2022;may;168838561;79215327;89623234;62315083;27308151;4;12;149;1878;1360;Baja
Zonas Secundarias;Dos Quebradas Tasa;2022;jun;143173452;69076189;74097263;61923923;12173340;4;12;129;1476;1360;Baja
Zonas Secundarias;Dos Quebradas Tasa;2022;jul;115135786;67137647;47998139;63241534;-15243395;4;12;115;1161;1200;Perdida
Zonas Secundarias;Dos Quebradas Tasa;2022;ago;176590135;96052731;80537404;68173810;12363594;4;13;128;1936;1360;Baja
Zonas Secundarias;Dos Quebradas Tasa;2022;sep;132990212;65455123;67535089;59931561;7603528;4;12;117;1357;1560;Baja
Zonas Secundarias;Dos Quebradas Tasa;2022;oct;164305697;85009291;79296406;80545324;-1248918;5;11;129;1641;1400;Perdida
Zonas Secundarias;Dos Quebradas Tasa;2022;nov;122682557;58183571;64498986;75452064;-10953078;5;10;104;1480;1400;Perdida
Zonas Secundarias;Dos Quebradas Tasa;2022;dic;111504468;60543206;50961262;87247675;-36286413;4;13;95;1168;1560;Perdida
Zonas Secundarias;Dos Quebradas Tasa;2023;ene;155815806;88929292;66886514;65404594;1481920;4;13;99;1814;1560;Perdida
Zonas Secundarias;Dos Quebradas Tasa;2023;feb;155948023;77040461;78907562;69112025;9795537;3;13;133;1686;1560;Baja
Zonas Secundarias;Dos Quebradas Tasa;2023;mar;114366022;87501947;26864075;51488808;-24624733;4;13;110;1131;1560;Perdida
Zonas Secundarias;Dos Quebradas Tasa;2023;abr;145458643;73698486;71760157;54595690;17164467;4;13;105;1420;1560;Baja
Zonas Secundarias;Dos Quebradas Tasa;2023;may;161529867;80743221;80786646;57179866;23606780;4;11;117;1483;1400;Baja
Zonas Secundarias;Dos Quebradas Tasa;2023;jun;161245088;85976746;75268342;67687931;7580411;4;11;126;1484;1400;Baja
Zonas Secundarias;Dos Quebradas Tasa;2023;jul;143468789;81009572;62459217;79470012;-17010795;4;11;105;1277;1400;Perdida
Zonas Secundarias;Dos Quebradas Tasa;2023;ago;188742535;87368683;101373852;84058604;17315248;4;11;157;1530;1400;Baja
Zonas Secundarias;Dos Quebradas Tasa;2023;sep;172515029;75186507;97328522;57558487;39770035;4;11;143;1552;1400;Media
Zonas Secundarias;Dos Quebradas Tasa;2023;oct;168796328;85212682;83583646;82293576;1290070;4;10;131;1459;1240;Perdida
Zonas Secundarias;Dos Quebradas Tasa;2023;nov;137939528;78115507;59824021;66469209;-6645188;4;10;131;1233;1240;Perdida
Zonas Secundarias;Dos Quebradas Tasa;2023;dic;126770560;65152233;61618327;88692342;-27074015;4;10;120;1095;1240;Perdida
Zonas Secundarias;Dos Quebradas Tasa;2024;ene;169872802;95204575;74668227;68671086;5997141;3;10;136;1480;1240;Baja
Zonas Secundarias;Dos Quebradas Tasa;2024;feb;144866809;71565176;73301633;57039749;16261884;3;10;137;1247;1240;Baja
Zonas Secundarias;Dos Quebradas Tasa;2024;mar;158065701;90896452;67169249;66781654;387595;3;10;126;1309;1240;Perdida
Zonas Secundarias;Dos Quebradas Tasa;2024;abr;154048670;80943529;73105141;57161204;15943937;3;10;131;1226;1400;Baja
Zonas Secundarias;Dos Quebradas Tasa;2024;may;172070461;85308401;86762060;76791596;9970464;3;8;135;1480;1040;Baja
Zonas Secundarias;Dos Quebradas Tasa;2024;jun;178543569;52850503;125693066;60736667;64956399;3;8;124;1476;1040;Media
Zonas Secundarias;Dos Quebradas Tasa;2024;jul;185944111;115895468;70048643;78809734;-8761091;3;10;137;1566;1200;Perdida
Zonas Secundarias;Dos Quebradas Tasa;2024;ago;159830559;96884581;62945978;71426938;-8480960;3;11;137;1209;1200;Perdida
Zonas Secundarias;Dos Quebradas Tasa;2024;sep;151426495;86430775;64995720;64475588;520132;3;11;138;1215;1200;Perdida
Zonas Secundarias;Dos Quebradas Tasa;2024;oct;206251743;84868317;121383426;96512043;24871383;3;11;132;1792;1200;Baja
Zonas Secundarias;Dos Quebradas Tasa;2024;nov;173469217;93061073;80408144;25658086;54750058;3;11;135;1335;1200;Media
Zonas Secundarias;Dos Quebradas Tasa;2024;dic;154603279;93257739;61345540;66635478;-5289938;3;11;151;1234;1200;Perdida
Zonas Secundarias;Girardot;2021;ene;4820725;2397882;2422843;369576;2053267;0;0;20;28;0;Media
Zonas Secundarias;Girardot;2021;feb;9458316;3775137;5683179;707771;4975408;0;0;28;40;0;Alta
Zonas Secundarias;Girardot;2021;mar;10199530;2648043;7551487;1981643;5569844;0;0;36;58;0;Alta
Zonas Secundarias;Girardot;2021;abr;8531683;482866;8048817;4756610;3292207;0;0;32;59;0;Media
Zonas Secundarias;Girardot;2021;may;9733498;2821588;6911910;2510669;4401241;0;0;35;58;0;Alta
Zonas Secundarias;Girardot;2021;jun;13324536;3517123;9807413;1700043;8107370;0;0;47;83;0;Alta
Zonas Secundarias;Girardot;2021;jul;9478620;2195216;7283404;2059619;5223785;0;0;42;54;0;Alta
Zonas Secundarias;Girardot;2021;ago;11647940;3179092;8468848;1104282;7364566;0;1;48;67;0;Alta
Zonas Secundarias;Girardot;2021;sep;12457614;3714664;8742950;4226951;4515999;0;1;36;77;0;Media
Zonas Secundarias;Girardot;2021;oct;9945855;4185295;5760560;1081818;4678742;0;1;41;54;0;Alta
Zonas Secundarias;Girardot;2021;nov;17005550;7153247;9852303;3246697;6605606;0;1;49;77;0;Media
Zonas Secundarias;Girardot;2021;dic;12831538;5125853;7705685;2834723;4870962;0;1;51;71;0;Media
Zonas Secundarias;Girardot;2022;ene;11820728;3827432;7993296;2682137;5311159;0;1;51;74;0;Alta
Zonas Secundarias;Girardot;2022;feb;11862787;4630591;7232196;789327;6442869;0;0;50;52;0;Alta
Zonas Secundarias;Girardot;2022;mar;15326953;4990289;10336664;7099414;3237250;0;1;71;86;160;Baja
Zonas Secundarias;Girardot;2022;abr;14189340;6921783;7267557;5056516;2211041;0;1;51;64;160;Baja
Zonas Secundarias;Girardot;2022;may;17033075;9021587;8011488;8426966;-415478;0;1;65;86;160;Perdida
Zonas Secundarias;Girardot;2022;jun;15785678;7997632;7788046;1978780;5809266;0;1;56;66;160;Media
Zonas Secundarias;Girardot;2022;jul;18147013;7971119;10175894;2592454;7583440;0;1;69;88;160;Media
Zonas Secundarias;Girardot;2022;ago;18243385;9081415;9161970;443279;8718691;0;1;60;81;160;Alta
Zonas Secundarias;Girardot;2022;sep;14105289;8619515;5485774;924956;4560818;0;1;50;55;160;Media
Zonas Secundarias;Girardot;2022;oct;12186207;6026940;6159267;2338660;3820607;0;1;50;60;160;Media
Zonas Secundarias;Girardot;2022;nov;11942096;7302847;4639249;2885262;1753987;0;1;48;48;160;Baja
Zonas Secundarias;Girardot;2022;dic;20067074;10022547;10044527;2785935;7258592;0;1;72;92;160;Media
Zonas Secundarias;Girardot;2023;ene;10970288;3759902;7210386;2843167;4367219;0;1;34;50;160;Media
Zonas Secundarias;Girardot;2023;feb;11456582;6982514;4474068;2929121;1544947;0;1;41;46;160;Baja
Zonas Secundarias;Girardot;2023;mar;23539421;9890214;13649207;1709542;11939665;0;1;56;74;160;Alta
Zonas Secundarias;Girardot;2023;abr;16925137;7316888;9608249;1752227;7856022;0;1;43;63;160;Alta
Zonas Secundarias;Girardot;2023;may;16753312;11036428;5716884;1689697;4027187;0;1;43;56;160;Media
Zonas Secundarias;Girardot;2023;jun;23131677;12278841;10852836;1297691;9555145;0;1;51;84;160;Media
Zonas Secundarias;Girardot;2023;jul;11946379;7980002;3966377;3724811;241566;0;1;37;41;160;Baja
Zonas Secundarias;Girardot;2023;ago;20244576;13472489;6772087;1915353;4856734;0;1;49;73;160;Media
Zonas Secundarias;Girardot;2023;sep;14314323;7923071;6391252;2943222;3448030;0;1;40;50;160;Media
Zonas Secundarias;Girardot;2023;oct;15805810;9696803;6109007;2261474;3847533;0;1;45;51;160;Media
Zonas Secundarias;Girardot;2023;nov;17382989;12010760;5372229;1927828;3444401;0;2;42;57;160;Baja
Zonas Secundarias;Girardot;2023;dic;19303441;11519383;7784058;3502087;4281971;0;2;51;73;160;Media
Zonas Secundarias;Girardot;2024;ene;23740968;13477169;10263799;1856929;8406870;0;2;50;81;160;Media
Zonas Secundarias;Girardot;2024;feb;18163825;13032916;5130909;2880614;2250295;0;2;53;77;160;Baja
Zonas Secundarias;Girardot;2024;mar;11863249;11234617;628632;2470639;-1842007;0;2;39;44;160;Perdida
Zonas Secundarias;Girardot;2024;abr;14951342;11152711;3798631;5907007;-2108376;0;2;43;62;160;Perdida
Zonas Secundarias;Girardot;2024;may;14421216;9891632;4529584;2250007;2279577;0;2;37;56;160;Baja
Zonas Secundarias;Girardot;2024;jun;17234659;13195317;4039342;1001980;3037362;0;2;51;65;160;Baja
Zonas Secundarias;Girardot;2024;jul;19049194;13454196;5594998;3669456;1925542;0;1;58;70;160;Baja
Zonas Secundarias;Girardot;2024;ago;27893770;18020663;9873107;2356267;7516840;0;1;56;91;160;Media
Zonas Secundarias;Girardot;2024;sep;9634343;8158377;1475966;4505390;-3029424;0;1;30;36;160;Perdida
Zonas Secundarias;Girardot;2024;oct;14999561;8479434;6520127;1862259;4657868;0;1;45;61;160;Media
Zonas Secundarias;Girardot;2024;nov;14861973;9683550;5178423;6086578;-908155;0;1;37;63;160;Perdida
Zonas Secundarias;Girardot;2024;dic;15760855;8340993;7419862;2875642;4544220;0;1;48;56;160;Media
Zonas Secundarias;Ibague TASA Taller;2021;ene;158576071;95284722;63291349;60601463;2689886;7;15;366;1467;2160;Baja
Zonas Secundarias;Ibague TASA Taller;2021;feb;204442514;98620588;105821926;64988800;40833126;7;15;380;1912;2160;Baja
Zonas Secundarias;Ibague TASA Taller;2021;mar;229315605;123172592;106143013;108472523;-2329510;7;15;490;2035;2160;Perdida
Zonas Secundarias;Ibague TASA Taller;2021;abr;202030737;104182153;97848584;84809406;13039178;9;16;471;1744;2480;Baja
Zonas Secundarias;Ibague TASA Taller;2021;may;175320701;107536954;67783747;81739800;-13956053;9;16;362;1755;2480;Perdida
Zonas Secundarias;Ibague TASA Taller;2021;jun;184974431;110086342;74888089;77663365;-2775276;8;16;412;1718;2480;Perdida
Zonas Secundarias;Ibague TASA Taller;2021;jul;212166445;108812901;103353544;79161849;24191695;8;16;476;2123;2480;Baja
Zonas Secundarias;Ibague TASA Taller;2021;ago;237875460;128534207;109341253;78738013;30603240;8;15;512;2284;2320;Baja
Zonas Secundarias;Ibague TASA Taller;2021;sep;244742857;133256858;111485999;78786344;32699655;7;15;529;2324;2320;Baja
Zonas Secundarias;Ibague TASA Taller;2021;oct;258844845;119037224;139807621;104491951;35315670;8;15;514;2295;2320;Baja
Zonas Secundarias;Ibague TASA Taller;2021;nov;241297820;133058133;108239687;75070967;33168720;8;14;449;2187;2160;Baja
Zonas Secundarias;Ibague TASA Taller;2021;dic;259382843;126765833;132617010;83706934;48910076;9;14;517;2185;2160;Baja
Zonas Secundarias;Ibague TASA Taller;2022;ene;218375906;112158116;106217790;89730131;16487659;9;15;459;1959;2320;Baja
Zonas Secundarias;Ibague TASA Taller;2022;feb;252254920;123482744;128772176;85049496;43722680;9;14;483;2361;2320;Baja
Zonas Secundarias;Ibague TASA Taller;2022;mar;248698343;121243696;127454647;69146331;58308316;9;15;518;2102;2320;Media
Zonas Secundarias;Ibague TASA Taller;2022;abr;263166049;125335716;137830333;85346767;52483566;8;16;447;2190;2320;Baja
Zonas Secundarias;Ibague TASA Taller;2022;may;255833848;131660021;124173827;84666953;39506874;7;16;457;2001;2320;Baja
Zonas Secundarias;Ibague TASA Taller;2022;jun;244892349;127539359;117352990;83491883;33861107;7;16;439;2066;2320;Baja
Zonas Secundarias;Ibague TASA Taller;2022;jul;259021398;134913721;124107677;189141562;-65033885;6;15;432;1933;2160;Perdida
Zonas Secundarias;Ibague TASA Taller;2022;ago;328740450;150671952;178068498;104930167;73138331;6;15;478;2817;2160;Media
Zonas Secundarias;Ibague TASA Taller;2022;sep;239367509;120418452;118949057;47734547;71214510;6;14;408;1864;2000;Media
Zonas Secundarias;Ibague TASA Taller;2022;oct;249898026;159096750;90801276;78137875;12663401;5;12;387;1822;1840;Baja
Zonas Secundarias;Ibague TASA Taller;2022;nov;223840642;115200225;108640417;56272255;52368162;5;13;396;1455;2000;Media
Zonas Secundarias;Ibague TASA Taller;2022;dic;249737420;100539831;149197589;72255788;76941801;5;13;416;1758;1840;Media
Zonas Secundarias;Ibague TASA Taller;2023;ene;273696982;116575530;157121452;78015478;79105974;6;13;455;2249;1840;Media
Zonas Secundarias;Ibague TASA Taller;2023;feb;201985187;111574742;90410445;60349167;30061278;6;14;321;1955;1840;Baja
Zonas Secundarias;Ibague TASA Taller;2023;mar;288644763;162793688;125851075;84393120;41457955;4;14;445;2298;1840;Baja
Zonas Secundarias;Ibague TASA Taller;2023;abr;262147967;141523446;120624521;62014658;58609863;7;14;398;1742;1840;Media
Zonas Secundarias;Ibague TASA Taller;2023;may;252238155;139409990;112828165;71270413;41557752;8;13;424;1851;1840;Baja
Zonas Secundarias;Ibague TASA Taller;2023;jun;212485650;123254387;89231263;91020778;-1789515;8;13;388;1442;2000;Perdida
Zonas Secundarias;Ibague TASA Taller;2023;jul;250029936;124062713;125967223;90669220;35298003;7;13;374;1795;2000;Baja
Zonas Secundarias;Ibague TASA Taller;2023;ago;292494778;150725059;141769719;112502521;29267198;8;14;424;2400;2000;Baja
Zonas Secundarias;Ibague TASA Taller;2023;sep;268641029;128692514;139948515;66224611;73723904;9;12;363;1754;1840;Media
Zonas Secundarias;Ibague TASA Taller;2023;oct;271907942;145697993;126209949;122027473;4182476;8;14;383;2249;2000;Baja
Zonas Secundarias;Ibague TASA Taller;2023;nov;221324386;147451990;73872396;101255249;-27382853;8;15;367;1407;2000;Perdida
Zonas Secundarias;Ibague TASA Taller;2023;dic;254965455;130227313;124738142;91285920;33452222;7;14;423;1703;1840;Baja
Zonas Secundarias;Ibague TASA Taller;2024;ene;243234939;131765138;111469801;115304146;-3834345;7;14;373;1741;1840;Perdida
Zonas Secundarias;Ibague TASA Taller;2024;feb;266520718;151786675;114734043;135820353;-21086310;8;15;364;2142;2000;Perdida
Zonas Secundarias;Ibague TASA Taller;2024;mar;271438658;160151898;111286760;89714823;21571937;8;15;387;1948;2000;Baja
Zonas Secundarias;Ibague TASA Taller;2024;abr;243452422;128760854;114691568;117386999;-2695431;7;15;378;1705;2000;Perdida
Zonas Secundarias;Ibague TASA Taller;2024;may;276486178;156396922;120089256;95129850;24959406;7;15;361;1700;2000;Baja
Zonas Secundarias;Ibague TASA Taller;2024;jun;254200045;147416192;106783853;85313944;21469909;6;15;337;1815;2000;Baja
Zonas Secundarias;Ibague TASA Taller;2024;jul;251449463;146833681;104615782;105719236;-1103454;5;14;356;1990;2000;Perdida
Zonas Secundarias;Ibague TASA Taller;2024;ago;318624050;173180512;145443538;100135403;45308135;5;14;411;2365;2000;Baja
Zonas Secundarias;Ibague TASA Taller;2024;sep;362135105;196937575;165197530;107867459;57330071;6;14;373;2592;2000;Baja
Zonas Secundarias;Ibague TASA Taller;2024;oct;325281601;154577616;170703985;90063123;80640862;6;14;370;2326;2000;Media
Zonas Secundarias;Ibague TASA Taller;2024;nov;339641228;170154197;169487031;120094107;49392924;7;14;356;2283;2000;Baja
Zonas Secundarias;Ibague TASA Taller;2024;dic;342556747;195408977;147147770;113076521;34071249;7;14;422;2479;2000;Baja
Zonas Secundarias;Neiva;2021;ene;167814578;79972852;87841726;69561803;18279923;7;13;366;1264;1910;Baja
Zonas Secundarias;Neiva;2021;feb;204203818;82256103;121947715;74335855;47611860;7;13;393;1458;1910;Media
Zonas Secundarias;Neiva;2021;mar;271949082;121502206;150446876;83233682;67213194;8;13;479;1992;1750;Media
Zonas Secundarias;Neiva;2021;abr;195717037;103387524;92329513;63818941;28510572;8;13;425;1560;1750;Baja
Zonas Secundarias;Neiva;2021;may;102075383;70213780;31861603;62758799;-30897196;8;13;228;850;1750;Perdida
Zonas Secundarias;Neiva;2021;jun;185295409;90456711;94838698;117314138;-22475440;7;13;418;1305;1750;Perdida
Zonas Secundarias;Neiva;2021;jul;209701571;97959633;111741938;36865844;74876094;7;13;451;1631;1750;Media
Zonas Secundarias;Neiva;2021;ago;199545875;97432787;102113088;76862057;25251031;8;12;443;1544;1590;Baja
Zonas Secundarias;Neiva;2021;sep;224697895;98773486;125924409;81570100;44354309;8;12;493;1638;1590;Baja
Zonas Secundarias;Neiva;2021;oct;221908829;103507314;118401515;76359964;42041551;8;11;457;1569;1550;Baja
Zonas Secundarias;Neiva;2021;nov;227591129;92054377;135536752;61767406;73769346;7;10;500;1694;1390;Media
Zonas Secundarias;Neiva;2021;dic;200768320;85187144;115581176;91152468;24428708;8;10;459;1508;1390;Baja
Zonas Secundarias;Neiva;2022;ene;182569478;83913461;98656017;78171750;20484267;7;11;375;1443;1590;Baja
Zonas Secundarias;Neiva;2022;feb;177886961;82952071;94934890;74061254;20873636;6;10;375;1577;1430;Baja
Zonas Secundarias;Neiva;2022;mar;225232354;106978360;118253994;82744390;35509604;8;12;399;1910;1590;Baja
Zonas Secundarias;Neiva;2022;abr;206115039;111575945;94539094;82813180;11725914;9;11;420;1458;1590;Baja
Zonas Secundarias;Neiva;2022;may;246912537;111921744;134990793;97325474;37665319;9;12;416;1998;1750;Baja
Zonas Secundarias;Neiva;2022;jun;229777214;106034315;123742899;135636656;-11893757;9;12;380;1823;1750;Perdida
Zonas Secundarias;Neiva;2022;jul;211391449;103881017;107510432;64032493;43477939;9;12;422;1564;1750;Baja
Zonas Secundarias;Neiva;2022;ago;248003731;102142408;145861323;96587572;49273751;9;12;456;1846;1750;Baja
Zonas Secundarias;Neiva;2022;sep;256591153;132093583;124497570;74843937;49653633;8;13;427;2074;1910;Baja
Zonas Secundarias;Neiva;2022;oct;256100151;110057420;146042731;86988129;59054602;8;14;396;1821;1910;Media
Zonas Secundarias;Neiva;2022;nov;276188609;114646566;161542043;91306872;70235171;10;13;447;2137;2070;Media
Zonas Secundarias;Neiva;2022;dic;279713837;134568270;145145567;104763100;40382467;9;15;475;2253;1910;Baja
Zonas Secundarias;Neiva;2023;ene;267000501;121870931;145129570;82683033;62446537;9;15;440;1847;1910;Media
Zonas Secundarias;Neiva;2023;feb;221131097;106764195;114366902;81298301;33068601;9;15;359;1574;1910;Baja
Zonas Secundarias;Neiva;2023;mar;254390126;134632244;119757882;100117988;19639894;9;15;417;1559;1910;Baja
Zonas Secundarias;Neiva;2023;abr;186720448;112940871;73779577;78944015;-5164438;10;14;350;1213;1710;Perdida
Zonas Secundarias;Neiva;2023;may;250836729;138430540;112406189;84812809;27593380;10;14;404;1620;1710;Baja
Zonas Secundarias;Neiva;2023;jun;236316523;129145425;107171098;92325650;14845448;8;15;362;1528;1710;Baja
Zonas Secundarias;Neiva;2023;jul;211781121;123238637;88542484;97489425;-8946941;8;15;356;1456;1710;Perdida
Zonas Secundarias;Neiva;2023;ago;254749736;115370448;139379288;110884348;28494940;8;15;410;1699;1710;Baja
Zonas Secundarias;Neiva;2023;sep;239327049;111977733;127349316;66688248;60661068;8;15;375;1799;1710;Media
Zonas Secundarias;Neiva;2023;oct;192150885;123859151;68291734;93068187;-24776453;9;14;347;1409;1710;Perdida
Zonas Secundarias;Neiva;2023;nov;272768258;137887942;134880316;100190181;34690135;9;13;388;1936;1710;Baja
Zonas Secundarias;Neiva;2023;dic;229770488;92159383;137611105;92725728;44885377;8;14;387;1640;1710;Baja
Zonas Secundarias;Neiva;2024;ene;255862941;136952270;118910671;87642827;31267844;8;14;416;1493;1710;Baja
Zonas Secundarias;Neiva;2024;feb;277947193;126359390;151587803;104765062;46822741;8;14;359;1963;1710;Baja
Zonas Secundarias;Neiva;2024;mar;209913272;124817823;85095449;96534256;-11438807;8;14;322;1455;1710;Perdida
Zonas Secundarias;Neiva;2024;abr;218109856;115652194;102457662;108444536;-5986874;8;13;350;1525;1550;Perdida
Zonas Secundarias;Neiva;2024;may;245786570;123677549;122109021;100608007;21501014;8;12;365;1658;1390;Baja
Zonas Secundarias;Neiva;2024;jun;214210419;120443596;93766823;100549710;-6782887;8;15;299;1363;1910;Perdida
Zonas Secundarias;Neiva;2024;jul;243394769;166761181;76633588;125406377;-48772789;8;15;380;1656;1910;Perdida
Zonas Secundarias;Neiva;2024;ago;243745102;142705378;101039724;110701715;-9661991;8;15;356;1502;1910;Perdida
Zonas Secundarias;Neiva;2024;sep;233832387;134536922;99295465;107224137;-7928672;8;15;355;1555;1910;Perdida
Zonas Secundarias;Neiva;2024;oct;278364249;128415371;149948878;97117798;52831080;8;15;337;1837;1910;Baja
Zonas Secundarias;Neiva;2024;nov;199732425;116067452;83664973;86292623;-2627650;7;15;303;1202;1910;Perdida
Zonas Secundarias;Neiva;2024;dic;250065762;127323721;122742041;100906073;21835968;7;14;378;1579;1750;Baja
Zonas Secundarias;Pereira Mecanica;2021;ene;137628557;58172450;79456107;63700536;15755571;8;8;422;825;1050;Baja
Zonas Secundarias;Pereira Mecanica;2021;feb;140331092;53374981;86956111;83382031;3574080;8;8;438;880;1050;Baja
Zonas Secundarias;Pereira Mecanica;2021;mar;168019446;67573510;100445936;64552064;35893872;8;9;498;1011;1210;Baja
Zonas Secundarias;Pereira Mecanica;2021;abr;113226000;50742383;62483617;63661218;-1177601;8;9;401;743;1210;Perdida
Zonas Secundarias;Pereira Mecanica;2021;may;95706387;50194655;45511732;88921411;-43409679;8;10;302;594;1210;Perdida
Zonas Secundarias;Pereira Mecanica;2021;jun;135917174;61748335;74168839;92021750;-17852911;8;10;444;864;1210;Perdida
Zonas Secundarias;Pereira Mecanica;2021;jul;154598869;69631837;84967032;75282812;9684220;8;10;473;939;1210;Baja
Zonas Secundarias;Pereira Mecanica;2021;ago;153302198;71693433;81608765;98114179;-16505414;8;11;513;966;1370;Perdida
Zonas Secundarias;Pereira Mecanica;2021;sep;154125071;72308094;81816977;91574221;-9757244;8;11;522;952;1530;Perdida
Zonas Secundarias;Pereira Mecanica;2021;oct;192043942;77921740;114122202;73125548;40996654;8;10;551;1127;1530;Baja
Zonas Secundarias;Pereira Mecanica;2021;nov;173180465;64237587;108942878;69254213;39688665;8;10;513;1052;1530;Media
Zonas Secundarias;Pereira Mecanica;2021;dic;187959690;67109864;120849826;80382415;40467411;9;10;596;1158;1530;Baja
Zonas Secundarias;Pereira Mecanica;2022;ene;179353307;72060711;107292596;88909212;18383384;9;10;583;1112;1530;Baja
Zonas Secundarias;Pereira Mecanica;2022;feb;172515407;69831124;102684283;97605234;5079049;9;11;537;1089;1530;Baja
Zonas Secundarias;Pereira Mecanica;2022;mar;197645287;76189334;121455953;89074759;32381194;9;10;597;1188;1370;Baja
Zonas Secundarias;Pereira Mecanica;2022;abr;190169251;73547358;116621893;88915926;27705967;9;10;521;1151;1370;Baja
Zonas Secundarias;Pereira Mecanica;2022;may;188684136;71628468;117055668;91032800;26022868;9;11;507;1114;1370;Baja
Zonas Secundarias;Pereira Mecanica;2022;jun;174201008;68689943;105511065;100267999;5243066;9;11;502;1049;1370;Baja
Zonas Secundarias;Pereira Mecanica;2022;jul;204494771;81540430;122954341;109730963;13223378;9;9;569;1117;1210;Baja
Zonas Secundarias;Pereira Mecanica;2022;ago;233850557;84441193;149409364;112736067;36673297;8;9;659;1303;1210;Baja
Zonas Secundarias;Pereira Mecanica;2022;sep;196996194;82603003;114393191;65338490;49054701;8;10;575;1129;1210;Media
Zonas Secundarias;Pereira Mecanica;2022;oct;184256973;74979985;109276988;95204287;14072701;8;11;481;1017;1210;Baja
Zonas Secundarias;Pereira Mecanica;2022;nov;210116884;83699227;126417657;98659995;27757662;8;10;537;1142;1370;Baja
Zonas Secundarias;Pereira Mecanica;2022;dic;211740303;114055150;97685153;102078667;-4393514;8;12;597;1179;1210;Perdida
Zonas Secundarias;Pereira Mecanica;2023;ene;228718127;99264458;129453669;83838574;45615095;8;12;619;1196;1210;Baja
Zonas Secundarias;Pereira Mecanica;2023;feb;180655882;78634690;102021192;89106058;12915134;9;12;501;1021;1210;Baja
Zonas Secundarias;Pereira Mecanica;2023;mar;209129525;100576063;108553462;87173566;21379896;9;12;545;1059;1210;Baja
Zonas Secundarias;Pereira Mecanica;2023;abr;182104001;82207451;99896550;97663208;2233342;9;12;456;934;1210;Baja
Zonas Secundarias;Pereira Mecanica;2023;may;173113288;88318342;84794946;89677588;-4882642;9;10;488;921;1210;Perdida
Zonas Secundarias;Pereira Mecanica;2023;jun;197765608;93726722;104038886;106433547;-2394661;9;10;497;962;1210;Perdida
Zonas Secundarias;Pereira Mecanica;2023;jul;180075267;90675986;89399281;116974348;-27575067;9;10;485;942;1210;Perdida
Zonas Secundarias;Pereira Mecanica;2023;ago;200361139;102178451;98182688;98483189;-300501;8;12;523;1048;1210;Perdida
Zonas Secundarias;Pereira Mecanica;2023;sep;182232730;78514493;103718237;80586220;23132017;8;13;445;918;1370;Baja
Zonas Secundarias;Pereira Mecanica;2023;oct;200946213;109374887;91571326;122660059;-31088733;7;13;474;994;1370;Perdida
Zonas Secundarias;Pereira Mecanica;2023;nov;171053730;95695999;75357731;91100175;-15742444;6;13;419;820;1370;Perdida
Zonas Secundarias;Pereira Mecanica;2023;dic;214519109;94204783;120314326;95685311;24629015;6;13;487;1079;1370;Baja
Zonas Secundarias;Pereira Mecanica;2024;ene;218139256;98264272;119874984;90997715;28877269;7;11;477;1024;1210;Baja
Zonas Secundarias;Pereira Mecanica;2024;feb;192903630;93768924;99134706;113603923;-14469217;8;10;433;884;1210;Perdida
Zonas Secundarias;Pereira Mecanica;2024;mar;188765936;96224269;92541667;90879260;1662407;8;10;405;852;1210;Perdida
Zonas Secundarias;Pereira Mecanica;2024;abr;210499387;95010891;115488496;103695061;11793435;8;11;444;914;1210;Baja
Zonas Secundarias;Pereira Mecanica;2024;may;220589820;102890876;117698944;111471634;6227310;8;11;440;1002;1210;Baja
Zonas Secundarias;Pereira Mecanica;2024;jun;214553283;81517045;133036238;125502556;7533682;8;10;410;976;1210;Baja
Zonas Secundarias;Pereira Mecanica;2024;jul;195178677;102523808;92654869;119302676;-26647807;7;10;396;906;1210;Perdida
Zonas Secundarias;Pereira Mecanica;2024;ago;193976094;90176481;103799613;161270414;-57470801;6;11;366;871;1210;Perdida
Zonas Secundarias;Pereira Mecanica;2024;sep;202515490;96415540;106099950;154596712;-48496762;6;11;405;964;1210;Perdida
Zonas Secundarias;Pereira Mecanica;2024;oct;199722764;81621367;118101397;173582518;-55481121;6;10;405;957;1210;Perdida
Zonas Secundarias;Pereira Mecanica;2024;nov;220997028;94403256;126593772;113853627;12740145;6;11;413;1032;1210;Baja
Zonas Secundarias;Pereira Mecanica;2024;dic;234510672;91522414;142988258;134185708;8802550;7;11;422;1011;1210;Baja
Zonas Secundarias;Tunja Taller;2021;ene;160748583;80228025;80520558;70332366;10188192;8;13;336;1313;1930;Baja
Zonas Secundarias;Tunja Taller;2021;feb;184606455;76714473;107891982;70337935;37554047;8;13;371;1613;1930;Baja
Zonas Secundarias;Tunja Taller;2021;mar;172776283;84856798;87919485;80544385;7375100;8;13;374;1433;1930;Baja
Zonas Secundarias;Tunja Taller;2021;abr;156975966;76852389;80123577;82535573;-2411996;7;13;379;1317;1930;Perdida
Zonas Secundarias;Tunja Taller;2021;may;114528965;75148593;39380372;77566873;-38186501;7;13;237;939;1930;Perdida
Zonas Secundarias;Tunja Taller;2021;jun;203545033;91058896;112486137;83143374;29342763;7;13;400;1822;1930;Baja
Zonas Secundarias;Tunja Taller;2021;jul;210795850;96667517;114128333;79255762;34872571;7;13;436;1840;1930;Baja
Zonas Secundarias;Tunja Taller;2021;ago;198649593;91068981;107580612;77910467;29670145;7;13;428;1631;1930;Baja
Zonas Secundarias;Tunja Taller;2021;sep;205394287;93621846;111772441;90315473;21456968;7;13;438;1851;1930;Baja
Zonas Secundarias;Tunja Taller;2021;oct;179800910;83258557;96542353;75317625;21224728;7;12;402;1422;1770;Baja
Zonas Secundarias;Tunja Taller;2021;nov;185554701;84873529;100681172;87981866;12699306;7;12;395;1566;1770;Baja
Zonas Secundarias;Tunja Taller;2021;dic;209221567;97897352;111324215;99972557;11351658;7;13;454;1898;1770;Baja
Zonas Secundarias;Tunja Taller;2022;ene;177871210;85862489;92008721;78812417;13196304;7;13;383;1579;1770;Baja
Zonas Secundarias;Tunja Taller;2022;feb;192385328;88602354;103782974;74402706;29380268;8;13;390;1622;1930;Baja
Zonas Secundarias;Tunja Taller;2022;mar;195537180;93040113;102497067;78412527;24084540;8;13;379;1710;1930;Baja
Zonas Secundarias;Tunja Taller;2022;abr;199493563;99481501;100012062;86608310;13403752;8;12;391;1737;1770;Baja
Zonas Secundarias;Tunja Taller;2022;may;189449819;88569598;100880221;87917831;12962390;8;12;376;1612;1770;Baja
Zonas Secundarias;Tunja Taller;2022;jun;190420604;93407766;97012838;74839443;22173395;8;12;342;1599;1770;Baja
Zonas Secundarias;Tunja Taller;2022;jul;199009694;84902085;114107609;78265765;35841844;8;12;394;1673;1770;Baja
Zonas Secundarias;Tunja Taller;2022;ago;248826895;115763387;133063508;81749372;51314136;7;10;464;2173;1570;Baja
Zonas Secundarias;Tunja Taller;2022;sep;207125084;102803862;104321222;83491463;20829759;7;13;392;1611;1930;Baja
Zonas Secundarias;Tunja Taller;2022;oct;214431680;96741750;117689930;71901411;45788519;7;12;368;1684;1770;Baja
Zonas Secundarias;Tunja Taller;2022;nov;175281578;94508543;80773035;83095015;-2321980;7;13;351;1351;1930;Perdida
Zonas Secundarias;Tunja Taller;2022;dic;252885004;110467346;142417658;82974038;59443620;6;13;441;2082;1930;Media
Zonas Secundarias;Tunja Taller;2023;ene;218371752;102951811;115419941;83979725;31440216;6;13;356;1665;1770;Baja
Zonas Secundarias;Tunja Taller;2023;feb;188681020;97750921;90930099;73739338;17190761;6;13;312;1627;1770;Baja
Zonas Secundarias;Tunja Taller;2023;mar;237460779;122539987;114920792;83633660;31287132;6;13;377;1836;1770;Baja
Zonas Secundarias;Tunja Taller;2023;abr;221160910;117957971;103202939;80163504;23039435;6;14;338;1772;1970;Baja
Zonas Secundarias;Tunja Taller;2023;may;292765545;158556522;134209023;81179791;53029232;6;14;431;2307;1970;Baja
Zonas Secundarias;Tunja Taller;2023;jun;226476561;135116100;91360461;102853956;-11493495;5;13;400;2008;1970;Perdida
Zonas Secundarias;Tunja Taller;2023;jul;202822377;120640209;82182168;81151982;1030186;5;12;364;1785;1970;Perdida
Zonas Secundarias;Tunja Taller;2023;ago;239291307;120825379;118465928;89297778;29168150;6;11;374;1771;1770;Baja
Zonas Secundarias;Tunja Taller;2023;sep;179737284;88155892;91581392;66963812;24617580;6;12;382;1271;1930;Baja
Zonas Secundarias;Tunja Taller;2023;oct;201920125;110508793;91411332;90751063;660269;6;12;352;1528;1930;Perdida
Zonas Secundarias;Tunja Taller;2023;nov;272166274;131415645;140750629;79402538;61348091;6;13;388;2103;1930;Media
Zonas Secundarias;Tunja Taller;2023;dic;246647262;113747733;132899529;108401959;24497570;6;13;420;1705;1930;Baja
Zonas Secundarias;Tunja Taller;2024;ene;220074580;130504293;89570287;87189394;2380893;6;13;365;1597;1930;Baja
Zonas Secundarias;Tunja Taller;2024;feb;232851887;134060698;98791189;92443982;6347207;6;14;358;1772;1930;Baja
Zonas Secundarias;Tunja Taller;2024;mar;204241280;116826039;87415241;97470119;-10054878;6;14;317;1473;1930;Perdida
Zonas Secundarias;Tunja Taller;2024;abr;275847320;146985960;128861360;89123364;39737996;6;13;361;2081;1930;Baja
Zonas Secundarias;Tunja Taller;2024;may;225972962;122099835;103873127;113700372;-9827245;6;13;350;1479;1930;Perdida
Zonas Secundarias;Tunja Taller;2024;jun;212340699;117081576;95259123;95590792;-331669;5;14;301;1511;1930;Perdida
Zonas Secundarias;Tunja Taller;2024;jul;257796596;132082021;125714575;84157683;41556892;5;14;362;1879;1930;Baja
Zonas Secundarias;Tunja Taller;2024;ago;260035870;143463248;116572622;88449287;28123335;5;13;361;1902;1770;Baja
Zonas Secundarias;Tunja Taller;2024;sep;245387163;127366162;118021001;92494992;25526009;5;14;325;1866;1770;Baja
Zonas Secundarias;Tunja Taller;2024;oct;226164553;99841503;126323050;104443576;21879474;5;14;344;1518;1770;Baja
Zonas Secundarias;Tunja Taller;2024;nov;255051617;153208119;101843498;94058996;7784502;5;14;341;1893;1770;Baja
Zonas Secundarias;Tunja Taller;2024;dic;270158625;116548472;153610153;147966864;5643289;5;13;428;1542;1770;Baja
Zonas Secundarias;Villavicencio TASA;2021;ene;195920485;93852153;102068332;85974642;16093690;7;13;459;1362;2090;Baja
Zonas Secundarias;Villavicencio TASA;2021;feb;253402196;104982068;148420128;88242621;60177507;7;15;480;2004;2090;Media
Zonas Secundarias;Villavicencio TASA;2021;mar;244100763;98214247;145886516;107998756;37887760;7;14;513;1801;1930;Baja
Zonas Secundarias;Villavicencio TASA;2021;abr;195918096;86142941;109775155;86729050;23046105;7;14;446;1590;2090;Baja
Zonas Secundarias;Villavicencio TASA;2021;may;198183643;94303834;103879809;100454514;3425295;7;13;392;1660;1930;Baja
Zonas Secundarias;Villavicencio TASA;2021;jun;212535670;98816534;113719136;55652684;58066452;7;14;440;1826;2090;Media
Zonas Secundarias;Villavicencio TASA;2021;jul;266514395;112993882;153520513;105114031;48406482;8;14;559;2122;2090;Baja
Zonas Secundarias;Villavicencio TASA;2021;ago;265972134;109649880;156322254;97040839;59281415;8;14;529;2377;2090;Media
Zonas Secundarias;Villavicencio TASA;2021;sep;288373190;123313076;165060114;128433975;36626139;8;15;539;2356;2250;Baja
Zonas Secundarias;Villavicencio TASA;2021;oct;285228468;122197987;163030481;106799195;56231286;8;16;580;2307;2570;Baja
Zonas Secundarias;Villavicencio TASA;2021;nov;250845639;111863978;138981661;126087598;12894063;8;17;514;1870;2570;Baja
Zonas Secundarias;Villavicencio TASA;2021;dic;262409494;120043099;142366395;119156121;23210274;7;18;501;2049;2570;Baja
Zonas Secundarias;Villavicencio TASA;2022;ene;262759065;110828438;151930627;106114702;45815925;7;17;499;2126;2410;Baja
Zonas Secundarias;Villavicencio TASA;2022;feb;257935644;118585829;139349815;117627202;21722613;6;17;532;1954;2410;Baja
Zonas Secundarias;Villavicencio TASA;2022;mar;312459278;140930737;171528541;111283208;60245333;7;19;546;2387;2410;Baja
Zonas Secundarias;Villavicencio TASA;2022;abr;271472586;117746078;153726508;97525462;56201046;7;19;483;1906;2410;Baja
Zonas Secundarias;Villavicencio TASA;2022;may;285844735;141054520;144790215;139015646;5774569;7;20;472;1970;2410;Baja
Zonas Secundarias;Villavicencio TASA;2022;jun;348554779;152186977;196367802;116877530;79490272;7;20;589;2443;2410;Media
Zonas Secundarias;Villavicencio TASA;2022;jul;310939674;129001980;181937694;109362802;72574892;7;18;534;2137;2250;Media
Zonas Secundarias;Villavicencio TASA;2022;ago;303109993;130796807;172313186;104387844;67925342;9;18;530;1977;2250;Media
Zonas Secundarias;Villavicencio TASA;2022;sep;355372571;139840157;215532414;111173206;104359208;9;17;582;2486;2410;Media
Zonas Secundarias;Villavicencio TASA;2022;oct;299304521;130055798;169248723;188396628;-19147905;9;17;485;2207;2410;Perdida
Zonas Secundarias;Villavicencio TASA;2022;nov;325399242;141142190;184257052;138735456;45521596;11;16;515;2186;2410;Baja
Zonas Secundarias;Villavicencio TASA;2022;dic;335180264;145188995;189991269;138120065;51871204;8;18;543;2283;2410;Baja
Zonas Secundarias;Villavicencio TASA;2023;ene;335116274;157208751;177907523;120812943;57094580;8;19;532;2039;2410;Baja
Zonas Secundarias;Villavicencio TASA;2023;feb;329974541;133834993;196139548;129148558;66990990;8;19;506;2528;2410;Baja
Zonas Secundarias;Villavicencio TASA;2023;mar;382119302;175532116;206587186;147143052;59444134;9;19;570;2486;2410;Baja
Zonas Secundarias;Villavicencio TASA;2023;abr;342317498;171308525;171008973;126674340;44334633;10;19;506;2051;2410;Baja
Zonas Secundarias;Villavicencio TASA;2023;may;403765400;187949407;215815993;116763511;99052482;9;17;575;2688;2250;Media
Zonas Secundarias;Villavicencio TASA;2023;jun;375596910;187340427;188256483;149395145;38861338;8;19;599;2334;2410;Baja
Zonas Secundarias;Villavicencio TASA;2023;jul;374870675;184077385;190793290;107908584;82884706;9;19;516;2410;2410;Media
Zonas Secundarias;Villavicencio TASA;2023;ago;385899660;186582329;199317331;186397120;12920211;9;19;511;2445;2410;Baja
Zonas Secundarias;Villavicencio TASA;2023;sep;361994215;154459153;207535062;109935994;97599068;7;19;522;2353;2410;Media
Zonas Secundarias;Villavicencio TASA;2023;oct;357901248;151653453;206247795;135427256;70820539;8;16;477;2181;2090;Baja
Zonas Secundarias;Villavicencio TASA;2023;nov;349222718;151174878;198047840;132681332;65366508;8;15;496;2623;2250;Baja
Zonas Secundarias;Villavicencio TASA;2023;dic;357842242;150228340;207613902;124345229;83268673;8;15;553;2204;2250;Media
Zonas Secundarias;Villavicencio TASA;2024;ene;343652293;172331694;171320599;140704027;30616572;8;15;501;2131;2250;Baja
Zonas Secundarias;Villavicencio TASA;2024;feb;390292553;164006771;226285782;149672841;76612941;8;16;503;2716;2250;Baja
Zonas Secundarias;Villavicencio TASA;2024;mar;339122571;187032750;152089821;140748702;11341119;8;16;454;2095;2250;Baja
Zonas Secundarias;Villavicencio TASA;2024;abr;401071844;169871859;231199985;149020167;82179818;8;16;523;2387;1890;Baja
Zonas Secundarias;Villavicencio TASA;2024;may;380016684;181860049;198156635;129287087;68869548;8;17;527;2065;2250;Baja
Zonas Secundarias;Villavicencio TASA;2024;jun;366686684;188534849;178151835;119977439;58174396;9;17;473;2015;2250;Baja
Zonas Secundarias;Villavicencio TASA;2024;jul;409004566;180134566;228870000;170697886;58172114;9;17;590;2302;2250;Baja
Zonas Secundarias;Villavicencio TASA;2024;ago;345090843;175213366;169877477;163899643;5977834;9;19;565;2065;2410;Baja
Zonas Secundarias;Villavicencio TASA;2024;sep;357922130;176541279;181380851;142627097;38753754;9;19;485;2065;2410;Baja
Zonas Secundarias;Villavicencio TASA;2024;oct;385966268;178964883;207001385;139668974;67332411;9;17;524;2459;2410;Baja
Zonas Secundarias;Villavicencio TASA;2024;nov;394862575;185541560;209321015;160383236;48937779;9;19;460;2305;2770;Baja
Zonas Secundarias;Villavicencio TASA;2024;dic;407378341;184785777;222592564;210393262;12199302;9;18;541;2107;2610;Baja
Zonas Secundarias;Yopal;2021;ene;67145975;43992563;23153412;37364370;-14210958;3;7;169;454;840;Perdida
Zonas Secundarias;Yopal;2021;feb;101261339;66556439;34704900;50138286;-15433386;3;7;201;909;840;Perdida
Zonas Secundarias;Yopal;2021;mar;138547889;60003244;78544645;37869706;40674939;4;6;222;987;840;Media
Zonas Secundarias;Yopal;2021;abr;90577920;47669080;42908840;47860638;-4951798;4;7;206;717;680;Perdida
Zonas Secundarias;Yopal;2021;may;87744496;50763169;36981327;43505454;-6524127;5;7;152;780;680;Perdida
Zonas Secundarias;Yopal;2021;jun;72209873;43072820;29137053;50950224;-21813171;5;7;186;579;680;Perdida
Zonas Secundarias;Yopal;2021;jul;105365872;49511470;55854402;51757144;4097258;5;7;245;771;680;Baja
Zonas Secundarias;Yopal;2021;ago;99385733;51827967;47557766;55318211;-7760445;5;7;211;911;680;Perdida
Zonas Secundarias;Yopal;2021;sep;110708898;55335898;55373000;59882992;-4509992;5;8;235;959;840;Perdida
Zonas Secundarias;Yopal;2021;oct;117825765;56165352;61660413;57358303;4302110;5;6;232;881;840;Baja
Zonas Secundarias;Yopal;2021;nov;109552167;51721791;57830376;52134134;5696242;5;7;198;926;840;Baja
Zonas Secundarias;Yopal;2021;dic;91299237;47795907;43503330;57456541;-13953211;5;7;213;647;840;Perdida
Zonas Secundarias;Yopal;2022;ene;90468195;46989552;43478643;58465964;-14987321;5;6;190;755;680;Perdida
Zonas Secundarias;Yopal;2022;feb;115824894;49427240;66397654;80548108;-14150454;6;6;205;913;680;Perdida
Zonas Secundarias;Yopal;2022;mar;119042303;57448706;61593597;57533901;4059696;6;7;232;946;840;Baja
Zonas Secundarias;Yopal;2022;abr;97666530;56794979;40871551;90762874;-49891323;6;7;225;679;840;Perdida
Zonas Secundarias;Yopal;2022;may;124984555;54643082;70341473;82821502;-12480029;6;6;222;943;840;Perdida
Zonas Secundarias;Yopal;2022;jun;119427499;51186162;68241337;65230043;3011294;6;6;236;714;840;Baja
Zonas Secundarias;Yopal;2022;jul;128732189;58029513;70702676;40820991;29881685;5;7;241;921;1000;Media
Zonas Secundarias;Yopal;2022;ago;143849933;59985809;83864124;50183437;33680687;6;7;229;948;1000;Media
Zonas Secundarias;Yopal;2022;sep;139397324;59935859;79461465;69283403;10178062;6;7;246;993;1000;Baja
Zonas Secundarias;Yopal;2022;oct;128828791;56746726;72082065;63486246;8595819;6;7;217;935;1000;Baja
Zonas Secundarias;Yopal;2022;nov;108253374;54956023;53297351;59380630;-6083279;6;8;207;880;1160;Perdida
Zonas Secundarias;Yopal;2022;dic;120433001;50633725;69799276;39565926;30233350;6;8;229;956;1160;Media
Zonas Secundarias;Yopal;2023;ene;125734596;59408645;66325951;57493242;8832709;6;7;204;855;1000;Baja
Zonas Secundarias;Yopal;2023;feb;102811352;48329922;54481430;68727863;-14246433;5;6;180;746;840;Perdida
Zonas Secundarias;Yopal;2023;mar;129952054;61667450;68284604;52169447;16115157;5;7;208;767;840;Baja
Zonas Secundarias;Yopal;2023;abr;118294186;60645307;57648879;64927045;-7278166;6;7;189;829;840;Perdida
Zonas Secundarias;Yopal;2023;may;152402866;77284701;75118165;103754265;-28636100;5;7;224;1021;840;Perdida
Zonas Secundarias;Yopal;2023;jun;148517399;73009711;75507688;67510692;7996996;6;8;223;1010;1000;Baja
Zonas Secundarias;Yopal;2023;jul;165033170;73552912;91480258;77664894;13815364;6;8;214;1018;1000;Baja
Zonas Secundarias;Yopal;2023;ago;111307167;55813885;55493282;69083403;-13590121;5;7;182;774;840;Perdida
Zonas Secundarias;Yopal;2023;sep;118890741;54084886;64805855;64729875;75980;5;6;191;930;840;Perdida
Zonas Secundarias;Yopal;2023;oct;141684550;66141939;75542611;54307015;21235596;5;6;205;1055;840;Baja
Zonas Secundarias;Yopal;2023;nov;139084654;70454989;68629665;48002796;20626869;5;7;184;1038;840;Baja
Zonas Secundarias;Yopal;2023;dic;110178591;38345892;71832699;49268276;22564423;4;7;178;647;840;Baja
Zonas Secundarias;Yopal;2024;ene;128360942;71125426;57235516;57783935;-548419;4;7;199;817;840;Perdida
Zonas Secundarias;Yopal;2024;feb;146629009;65007560;81621449;54895875;26725574;4;8;188;1055;1000;Baja
Zonas Secundarias;Yopal;2024;mar;133165743;71869509;61296234;59580342;1715892;5;8;199;743;1000;Baja
Zonas Secundarias;Yopal;2024;abr;160638300;71368395;89269905;70092012;19177893;5;7;196;934;840;Baja
Zonas Secundarias;Yopal;2024;may;154209777;69064570;85145207;67959269;17185938;6;6;223;839;840;Baja
Zonas Secundarias;Yopal;2024;jun;156926453;79048963;77877490;72997663;4879827;5;7;165;797;1000;Baja
Zonas Secundarias;Yopal;2024;jul;161660654;72991060;88669594;59576580;29093014;6;7;215;1069;1000;Baja
Zonas Secundarias;Yopal;2024;ago;150568789;73229444;77339345;60322995;17016350;6;6;238;745;1000;Baja
Zonas Secundarias;Yopal;2024;sep;150964197;75876697;75087500;60933888;14153612;6;6;191;964;800;Baja
Zonas Secundarias;Yopal;2024;oct;168150806;66328898;101821908;51346068;50475840;6;7;214;927;1000;Media
Zonas Secundarias;Yopal;2024;nov;167793290;69331942;98461348;70184065;28277283;5;7;216;981;1000;Baja
Zonas Secundarias;Yopal;2024;dic;192507231;71920735;120586496;63637251;56949245;5;6;236;994;1000;Media
